A1BG	IgA glomerulonephritis
AKT3	IgA glomerulonephritis
MED6	breast cancer
NAALAD2	prostate cancer
SIGLEC14	IgA glomerulonephritis
ACOT8	prostate cancer
GNPDA1	obesity
ZBTB33	breast cancer
POM121C	human immunodeficiency virus infectious disease
SRA1	breast cancer
ZNF730	breast cancer
IZUMO3	pneumoconiosis
ZNF737	breast cancer
KIF28P	IgA glomerulonephritis
CD300LD	IgA glomerulonephritis
ZNF705E	breast cancer
ZNF717	breast cancer
ZNF705G	breast cancer
FOXO6	IgA glomerulonephritis
KIR2DS2	IgA glomerulonephritis
CLDN24	prostate cancer
PLA2G4B	prostate cancer
HDAC5	breast cancer
BCL2L10	prostate cancer
TOMM6	IgA glomerulonephritis
INSL5	prostate cancer
FRAT1	breast cancer
PIGK	paroxysmal nocturnal hemoglobinuria
ARHGEF33	IgA glomerulonephritis
MEF2B	breast cancer
RASA4B	IgA glomerulonephritis
CMC4	IgA glomerulonephritis
USP17L10	IgA glomerulonephritis
WASH1	IgA glomerulonephritis
USP17L11	IgA glomerulonephritis
USP17L12	IgA glomerulonephritis
ZNF729	breast cancer
USP17L13	IgA glomerulonephritis
USP17L17	IgA glomerulonephritis
USP17L18	IgA glomerulonephritis
USP17L19	IgA glomerulonephritis
USP17L20	IgA glomerulonephritis
USP17L21	IgA glomerulonephritis
USP17L22	IgA glomerulonephritis
TIMM23	IgA glomerulonephritis
USP17L15	IgA glomerulonephritis
ZNF605	breast cancer
SPDYE2B	IgA glomerulonephritis
PARP3	IgA glomerulonephritis
CDH6	prostate cancer
TOM1	IgA glomerulonephritis
SH2D3C	IgA glomerulonephritis
RANBP9	IgA glomerulonephritis
CDH7	prostate cancer
TCEB3CL2	peripheral nervous system disease
AP1M2	IgA glomerulonephritis
NDUFC2-KCTD14	mitochondrial complex I deficiency
C8orf44-SGK3	IgA glomerulonephritis
ZNF840P	breast cancer
UBA2	multiple sclerosis
FARSB	tyrosinemia
CDH8	prostate cancer
ABCF2	IgA glomerulonephritis
SCAMP2	autistic disorder
SCAMP3	IgA glomerulonephritis
IL18BP	IgA glomerulonephritis
MUC12	IgA glomerulonephritis
SNUPN	human immunodeficiency virus infectious disease
HUWE1	IgA glomerulonephritis
PTPRU	IgA glomerulonephritis
ATP9A	autistic disorder
PDCD7	human immunodeficiency virus infectious disease
EDIL3	IgA glomerulonephritis
KCNK7	type 2 diabetes mellitus
CDH11	prostate cancer
ARPC5	IgA glomerulonephritis
ARPC4	IgA glomerulonephritis
ARPC3	IgA glomerulonephritis
ARPC1B	IgA glomerulonephritis
ACTR3	IgA glomerulonephritis
ADAM8	IgA glomerulonephritis
CTDSP2	IgA glomerulonephritis
SGK2	IgA glomerulonephritis
PREB	IgA glomerulonephritis
HIPK3	IgA glomerulonephritis
ACTR1B	IgA glomerulonephritis
ACTR1A	IgA glomerulonephritis
ARL4A	breast cancer
DNAL4	IgA glomerulonephritis
ZNF263	breast cancer
LRPPRC	IgA glomerulonephritis
PDIA6	prostate cancer
BCAP31	IgA glomerulonephritis
CELA3A	IgA glomerulonephritis
ARFRP1	IgA glomerulonephritis
CDH16	breast cancer
SUGP2	human immunodeficiency virus infectious disease
ADGRG2	lung disease
CDH17	prostate cancer
CEBPZ	IgA glomerulonephritis
TRIM28	breast cancer
RASA4	IgA glomerulonephritis
LPCAT3	IgA glomerulonephritis
WASF2	IgA glomerulonephritis
CHST4	IgA glomerulonephritis
SLC25A13	IgA glomerulonephritis
SLC25A15	amino acid metabolic disorder
ZNF197	breast cancer
DHRS9	retinitis pigmentosa
RCL1	dyskeratosis congenita
ZNF256	breast cancer
SORBS3	prostate cancer
CNIH1	IgA glomerulonephritis
CDK3	IgA glomerulonephritis
RBM5	human immunodeficiency virus infectious disease
RNF41	IgA glomerulonephritis
ALG3	IgA glomerulonephritis
PRMT3	IgA glomerulonephritis
MPHOSPH10	dyskeratosis congenita
MPHOSPH6	stomach cancer
NME6	IgA glomerulonephritis
MPZL2	breast cancer
TRIM13	IgA glomerulonephritis
EIF1	breast cancer
FLOT1	autistic disorder
DDX39A	human immunodeficiency virus infectious disease
PSMD14	IgA glomerulonephritis
AK6	IgA glomerulonephritis
CTDSPL	IgA glomerulonephritis
KLRG1	IgA glomerulonephritis
GDF11	breast cancer
ZNF443	breast cancer
CD96	IgA glomerulonephritis
PLIN3	IgA glomerulonephritis
COQ7	multiple system atrophy
RCAN2	IgA glomerulonephritis
RASGRP2	IgA glomerulonephritis
DCAF7	IgA glomerulonephritis
CDK8	breast cancer
MRPS31	breast cancer
CALCOCO2	IgA glomerulonephritis
GPHN	xanthinuria
RABEPK	IgA glomerulonephritis
TIMM17B	IgA glomerulonephritis
SLC17A2	breast cancer
POP7	stomach cancer
GLYAT	lung benign neoplasm
CDK9	breast cancer
SRRM1	human immunodeficiency virus infectious disease
SPRY3	IgA glomerulonephritis
SPRY1	prostate cancer
STAM2	IgA glomerulonephritis
CNKSR1	IgA glomerulonephritis
DENND4A	IgA glomerulonephritis
SF3B4	human immunodeficiency virus infectious disease
RAMP1	IgA glomerulonephritis
RAMP3	IgA glomerulonephritis
AKAP8	IgA glomerulonephritis
FSTL3	breast cancer
CBSL	prostate cancer
U2AF1L5	human immunodeficiency virus infectious disease
STUB1	IgA glomerulonephritis
NET1	IgA glomerulonephritis
UBE4B	IgA glomerulonephritis
LOC400927-CSNK1E	IgA glomerulonephritis
BET1	IgA glomerulonephritis
CWC27	human immunodeficiency virus infectious disease
SAP18	breast cancer
SMNDC1	human immunodeficiency virus infectious disease
BCAS2	human immunodeficiency virus infectious disease
RGS19	IgA glomerulonephritis
EIF1B	human immunodeficiency virus infectious disease
SF3A1	human immunodeficiency virus infectious disease
DNAJA2	prostate cancer
PAK4	IgA glomerulonephritis
MARCH6	IgA glomerulonephritis
SNAPC5	Treacher Collins syndrome
TCIRG1	IgA glomerulonephritis
RTN3	autistic disorder
NMUR1	IgA glomerulonephritis
SMYD5	breast cancer
RRAGB	breast cancer
SIRPB1	IgA glomerulonephritis
TMEM5	IgA glomerulonephritis
B3GNT3	IgA glomerulonephritis
CLEC4M	IgA glomerulonephritis
PCGF3	breast cancer
TRDN	hypertension
ABCA10	prostate cancer
ABCA9	prostate cancer
ABCA8	prostate cancer
WARS2	IgA glomerulonephritis
HMG20B	IgA glomerulonephritis
CACNG3	prostate cancer
CACNG2	autistic disorder
IRF9	IgA glomerulonephritis
BPNT1	prostate cancer
TUBB4A	IgA glomerulonephritis
TUBB4B	IgA glomerulonephritis
BTN3A3	IgA glomerulonephritis
BTN2A2	IgA glomerulonephritis
SYCP2	IgA glomerulonephritis
CEPT1	IgA glomerulonephritis
MYL12B	IgA glomerulonephritis
ANAPC10	IgA glomerulonephritis
PRG3	IgA glomerulonephritis
ATP8A1	IgA glomerulonephritis
CDS1	IgA glomerulonephritis
PEMT	IgA glomerulonephritis
ST3GAL6	IgA glomerulonephritis
CDSN	prostate cancer
PRMT5	IgA glomerulonephritis
TESK2	IgA glomerulonephritis
CD2BP2	human immunodeficiency virus infectious disease
UBAC1	IgA glomerulonephritis
CDIPT	IgA glomerulonephritis
ARIH2	IgA glomerulonephritis
TUBGCP3	IgA glomerulonephritis
SEC24B	IgA glomerulonephritis
CD52	IgA glomerulonephritis
CDC42EP2	IgA glomerulonephritis
C1D	stomach cancer
CDX1	breast cancer
TIMM17A	IgA glomerulonephritis
MCRS1	IgA glomerulonephritis
FAM3C	IgA glomerulonephritis
ACAA2	obesity
CDX2	breast cancer
PPIE	IgA glomerulonephritis
ECI2	prostate cancer
BAIAP2	IgA glomerulonephritis
MAD2L2	IgA glomerulonephritis
CDX4	breast cancer
SLC30A9	IgA glomerulonephritis
PPIH	human immunodeficiency virus infectious disease
COG5	IgA glomerulonephritis
TIMM44	IgA glomerulonephritis
PFDN6	IgA glomerulonephritis
TADA3	IgA glomerulonephritis
UBE2E3	IgA glomerulonephritis
SLC25A17	IgA glomerulonephritis
CEACAM5	IgA glomerulonephritis
EIF3M	Diamond-Blackfan anemia
NXF1	human immunodeficiency virus infectious disease
CAP2	prostate cancer
CREB3	IgA glomerulonephritis
LRRC41	IgA glomerulonephritis
VTI1B	IgA glomerulonephritis
VAT1	IgA glomerulonephritis
UNC13B	autistic disorder
SEMA6C	IgA glomerulonephritis
SEMA6B	IgA glomerulonephritis
SEMA4F	IgA glomerulonephritis
SEMA4D	prostate cancer
SEMA4B	IgA glomerulonephritis
APPBP2	prostate cancer
MYBBP1A	breast cancer
ZNF211	breast cancer
DDX17	prostate cancer
DEAF1	prostate cancer
CHERP	human immunodeficiency virus infectious disease
KAT5	breast cancer
HYOU1	prostate cancer
IPO8	prostate cancer
RNASEH2A	Meier-Gorlin syndrome
P3H3	IgA glomerulonephritis
CEBPG	prostate cancer
DCTN2	IgA glomerulonephritis
ANP32B	IgA glomerulonephritis
ARPC1A	IgA glomerulonephritis
AGPAT1	IgA glomerulonephritis
RPP30	stomach cancer
SPTLC1	IgA glomerulonephritis
SLC35A1	IgA glomerulonephritis
CEL	prostate cancer
SLC19A2	prostate cancer
CXCL13	IgA glomerulonephritis
AKAP3	IgA glomerulonephritis
SLU7	human immunodeficiency virus infectious disease
DPYSL4	prostate cancer
MRPL28	breast cancer
CCT4	Bardet-Biedl syndrome
GNLY	IgA glomerulonephritis
SORBS1	IgA glomerulonephritis
POMT1	IgA glomerulonephritis
CENPB	IgA glomerulonephritis
AHSA1	IgA glomerulonephritis
CENPC	IgA glomerulonephritis
CDC42EP3	IgA glomerulonephritis
SH2B2	IgA glomerulonephritis
PAIP1	stomach cancer
PAICS	breast cancer
TBL3	dyskeratosis congenita
MXD4	prostate cancer
HEXIM1	breast cancer
RBCK1	IgA glomerulonephritis
POLR3F	Treacher Collins syndrome
POLR3G	Treacher Collins syndrome
POLR3C	Treacher Collins syndrome
MYL12A	prostate cancer
TAF6L	breast cancer
PDPN	IgA glomerulonephritis
ATP5L	mitochondrial complex I deficiency
RAD51AP1	breast cancer
LEFTY1	breast cancer
EXOC5	Bardet-Biedl syndrome
NPRL2	breast cancer
IGF2BP1	IgA glomerulonephritis
CAMKK2	IgA glomerulonephritis
PRELID3A	breast cancer
MTX2	IgA glomerulonephritis
YKT6	IgA glomerulonephritis
PMVK	porokeratosis
KHDRBS3	melanoma
KHDRBS1	IgA glomerulonephritis
CXCR6	IgA glomerulonephritis
CTCF	breast cancer
RRAGA	IgA glomerulonephritis
DCTN6	IgA glomerulonephritis
TNFSF13B	IgA glomerulonephritis
CSPG5	Ehlers-Danlos syndrome progeroid type
GNB5	IgA glomerulonephritis
EBP	porokeratosis
CLDN16	prostate cancer
CETN2	IgA glomerulonephritis
FUT9	IgA glomerulonephritis
RRH	IgA glomerulonephritis
CNPY3	IgA glomerulonephritis
TBC1D7-LOC100130357	IgA glomerulonephritis
USP39	human immunodeficiency virus infectious disease
CERS1	IgA glomerulonephritis
NRG3	IgA glomerulonephritis
UGT2B11	prostate cancer
POLQ	IgA glomerulonephritis
MGEA5	IgA glomerulonephritis
NUDC	IgA glomerulonephritis
PTGES3	prostate cancer
CFL2	IgA glomerulonephritis
STAG3	IgA glomerulonephritis
PTTG2	IgA glomerulonephritis
MAP3K2	IgA glomerulonephritis
KIF1C	IgA glomerulonephritis
GRAP	IgA glomerulonephritis
CAPN9	prostate cancer
GIPC1	IgA glomerulonephritis
NUP50	IgA glomerulonephritis
KDM5B	breast cancer
HBS1L	stomach cancer
AHCYL1	IgA glomerulonephritis
PLK2	breast cancer
ARPP19	IgA glomerulonephritis
ZNF234	breast cancer
ZNF266	breast cancer
ZNF274	breast cancer
NEK6	IgA glomerulonephritis
WDR4	stomach cancer
SLC17A3	IgA glomerulonephritis
NCKAP1	IgA glomerulonephritis
IQGAP2	IgA glomerulonephritis
VAMP5	IgA glomerulonephritis
ZNF273	breast cancer
ZNF460	breast cancer
ZNF268	breast cancer
OR5I1	endometriosis
RPP40	stomach cancer
CYSLTR1	prostate cancer
SEC24A	IgA glomerulonephritis
WASF3	IgA glomerulonephritis
NOXA1	IgA glomerulonephritis
UTP14A	dyskeratosis congenita
FRS3	breast cancer
FRS2	breast cancer
NEU3	IgA glomerulonephritis
FAXDC2	porokeratosis
FAM114A2	IgA glomerulonephritis
CEACAM3	IgA glomerulonephritis
PPP1R17	IgA glomerulonephritis
TUBGCP2	IgA glomerulonephritis
CD3EAP	breast cancer
RUVBL2	IgA glomerulonephritis
ADAM28	IgA glomerulonephritis
SLC22A7	prostate cancer
USP20	IgA glomerulonephritis
USP19	IgA glomerulonephritis
CEACAM7	IgA glomerulonephritis
HCST	IgA glomerulonephritis
CD300C	IgA glomerulonephritis
ME3	obesity
CFHR4	IgA glomerulonephritis
CEACAM8	IgA glomerulonephritis
MRPS30	breast cancer
WDR3	dyskeratosis congenita
NPFFR2	IgA glomerulonephritis
PROKR1	IgA glomerulonephritis
GPR83	IgA glomerulonephritis
RAB10	IgA glomerulonephritis
MMP24	prostate cancer
LYVE1	IgA glomerulonephritis
CPSF4	human immunodeficiency virus infectious disease
DHRS4	prostate cancer
MAN1A2	IgA glomerulonephritis
TRAFD1	IgA glomerulonephritis
TXNL4A	human immunodeficiency virus infectious disease
SUGT1	IgA glomerulonephritis
GADD45G	IgA glomerulonephritis
EDAR	IgA glomerulonephritis
PAPOLA	human immunodeficiency virus infectious disease
TCERG1	human immunodeficiency virus infectious disease
MAGED2	IgA glomerulonephritis
COPS8	IgA glomerulonephritis
RNPS1	human immunodeficiency virus infectious disease
DBF4	Meier-Gorlin syndrome
SRSF8	human immunodeficiency virus infectious disease
APOBEC2	breast cancer
GPR75	autistic disorder
EHD1	IgA glomerulonephritis
POP1	stomach cancer
UGT2A1	prostate cancer
PRSS21	IgA glomerulonephritis
MSL3	breast cancer
AP3M2	IgA glomerulonephritis
HNRNPA0	human immunodeficiency virus infectious disease
SEC61B	prostate cancer
PDIA5	prostate cancer
PNRC1	prostate cancer
LMAN2	IgA glomerulonephritis
RAB40B	IgA glomerulonephritis
CKAP4	IgA glomerulonephritis
YWHAQ	IgA glomerulonephritis
TMED10	IgA glomerulonephritis
UQCR11	mitochondrial complex I deficiency
CLP1	human immunodeficiency virus infectious disease
SLC38A3	IgA glomerulonephritis
SF3B2	human immunodeficiency virus infectious disease
SDS	maple syrup urine disease
SLC27A5	prostate cancer
SLC27A4	IgA glomerulonephritis
SLC27A3	prostate cancer
SLC27A2	prostate cancer
CHAD	IgA glomerulonephritis
TLK2	IgA glomerulonephritis
KDELR2	IgA glomerulonephritis
KDELR3	IgA glomerulonephritis
ATF7	breast cancer
SNRNP27	human immunodeficiency virus infectious disease
LIAS	prostate cancer
RAB35	IgA glomerulonephritis
TDRKH	prostate cancer
LILRA1	IgA glomerulonephritis
LILRB3	IgA glomerulonephritis
LILRA3	IgA glomerulonephritis
LILRA2	IgA glomerulonephritis
RBPMS	prostate cancer
RAB31	IgA glomerulonephritis
ADAP1	IgA glomerulonephritis
DSTN	prostate cancer
GTF2A1L	peripheral nervous system disease
STON1	IgA glomerulonephritis
RCC1	IgA glomerulonephritis
B4GAT1	IgA glomerulonephritis
PAPD7	IgA glomerulonephritis
SLC35D2	IgA glomerulonephritis
ADRM1	IgA glomerulonephritis
CHD1	IgA glomerulonephritis
NUDT21	human immunodeficiency virus infectious disease
ABHD2	prostate cancer
WWP1	IgA glomerulonephritis
WWP2	IgA glomerulonephritis
CNTRL	IgA glomerulonephritis
SNRNP35	human immunodeficiency virus infectious disease
RAPGEF4	IgA glomerulonephritis
TMEM115	IgA glomerulonephritis
DUSP14	breast cancer
TPPP	IgA glomerulonephritis
KERA	IgA glomerulonephritis
ESM1	IgA glomerulonephritis
ADAM30	pneumoconiosis
WDR5	breast cancer
CACFD1	autistic disorder
ADAMTS8	IgA glomerulonephritis
PTPN21	IgA glomerulonephritis
HNRNPUL1	human immunodeficiency virus infectious disease
KRR1	dyskeratosis congenita
KATNA1	IgA glomerulonephritis
PRDM7	breast cancer
PRDM4	IgA glomerulonephritis
HIBADH	maple syrup urine disease
CIT	IgA glomerulonephritis
FGFR1OP	IgA glomerulonephritis
BTN3A2	IgA glomerulonephritis
BTN3A1	IgA glomerulonephritis
BTN2A1	IgA glomerulonephritis
CD160	IgA glomerulonephritis
POLR3A	Treacher Collins syndrome
CLASRP	human immunodeficiency virus infectious disease
CAPN11	prostate cancer
PWP1	IgA glomerulonephritis
PKIG	prostate cancer
KAT7	breast cancer
DMC1	prostate cancer
PLA2G16	IgA glomerulonephritis
CORO1A	IgA glomerulonephritis
WDR45	IgA glomerulonephritis
AP4S1	IgA glomerulonephritis
LSM6	human immunodeficiency virus infectious disease
ERLIN2	IgA glomerulonephritis
NUDT4	IgA glomerulonephritis
NUDT5	breast cancer
NUDT3	IgA glomerulonephritis
SOX21	breast cancer
WDHD1	breast cancer
STRAP	IgA glomerulonephritis
BAZ1A	breast cancer
TREH	IgA glomerulonephritis
SLC2A6	IgA glomerulonephritis
MAP4K5	IgA glomerulonephritis
MAP4K1	IgA glomerulonephritis
INMT	prostate cancer
CELF3	prostate cancer
WBP4	human immunodeficiency virus infectious disease
ABCB8	sideroblastic anemia
SUPT16H	peripheral nervous system disease
ADCY6	IgA glomerulonephritis
POLI	IgA glomerulonephritis
KLK8	prostate cancer
FZD10	breast cancer
IRAK3	IgA glomerulonephritis
AKAP11	IgA glomerulonephritis
AKAP10	IgA glomerulonephritis
AKAP2	IgA glomerulonephritis
DDX20	human immunodeficiency virus infectious disease
CHML	IgA glomerulonephritis
MRPL3	breast cancer
RPL35	Diamond-Blackfan anemia
GALNT6	IgA glomerulonephritis
GALNT5	IgA glomerulonephritis
POLG2	IgA glomerulonephritis
PDCD10	IgA glomerulonephritis
CA5B	obesity
EGLN2	IgA glomerulonephritis
EGLN3	IgA glomerulonephritis
PADI2	IgA glomerulonephritis
BIRC8	IgA glomerulonephritis
PMF1	IgA glomerulonephritis
GPR176	IgA glomerulonephritis
PRKCDBP	IgA glomerulonephritis
SAT2	cerebrovascular disease
GTF3C6	Treacher Collins syndrome
GPR45	IgA glomerulonephritis
PTGDR2	IgA glomerulonephritis
PACSIN2	IgA glomerulonephritis
MAN1B1	IgA glomerulonephritis
SNX18	IgA glomerulonephritis
DCTN3	IgA glomerulonephritis
XPOT	stomach cancer
PXMP4	Zellweger syndrome
SNF8	IgA glomerulonephritis
TUBA3E	IgA glomerulonephritis
RDH13	prostate cancer
KLHL2	IgA glomerulonephritis
KLF8	IgA glomerulonephritis
SCN11A	prostate cancer
KRT71	prostate cancer
FDX1L	prostate cancer
HOGA1	glycine encephalopathy
MGAT4B	IgA glomerulonephritis
CYP4F8	prostate cancer
L3HYPDH	autistic disorder
TP53RK	stomach cancer
SGF29	breast cancer
VPS26B	IgA glomerulonephritis
GLB1L3	IgA glomerulonephritis
MED8	breast cancer
PLCD3	IgA glomerulonephritis
SLCO2B1	prostate cancer
PTH2	IgA glomerulonephritis
VPS45	IgA glomerulonephritis
LYPLA2	IgA glomerulonephritis
CDCA5	IgA glomerulonephritis
CD300A	IgA glomerulonephritis
COPE	IgA glomerulonephritis
RBPJL	IgA glomerulonephritis
IZUMO4	pneumoconiosis
ADAT3	stomach cancer
GPR182	prostate cancer
CHRM4	IgA glomerulonephritis
KIF12	IgA glomerulonephritis
DDX42	human immunodeficiency virus infectious disease
TMEM106A	IgA glomerulonephritis
FKBP9	IgA glomerulonephritis
STK38	Down syndrome
CHRM5	IgA glomerulonephritis
CTRC	prostate cancer
PHB2	prostate cancer
ACOT7	prostate cancer
PDAP1	IgA glomerulonephritis
TUSC2	IgA glomerulonephritis
CBX3	prostate cancer
U2AF2	human immunodeficiency virus infectious disease
CHRNA1	autistic disorder
EXOSC8	stomach cancer
GABARAPL2	IgA glomerulonephritis
AZIN2	prostate cancer
TUBA3D	IgA glomerulonephritis
SYNPO	prostate cancer
CHRNA2	autistic disorder
CYP2U1	prostate cancer
SDSL	maple syrup urine disease
PIK3IP1	IgA glomerulonephritis
HENMT1	prostate cancer
ZNF257	breast cancer
CHRNB1	prostate cancer
ZIM3	breast cancer
WBSCR22	dyskeratosis congenita
TRIM9	IgA glomerulonephritis
TXNRD3	prostate cancer
SIGLEC11	IgA glomerulonephritis
CHRNB3	autistic disorder
CHRND	autistic disorder
CHRNE	autistic disorder
CYGB	IgA glomerulonephritis
CARD16	IgA glomerulonephritis
PGLYRP2	IgA glomerulonephritis
PGLYRP3	IgA glomerulonephritis
GPRIN1	breast cancer
STK11IP	IgA glomerulonephritis
TUBGCP5	IgA glomerulonephritis
FMNL2	IgA glomerulonephritis
ESCO1	IgA glomerulonephritis
GALNT13	IgA glomerulonephritis
GNRHR2	IgA glomerulonephritis
SORCS1	breast cancer
OSBPL5	IgA glomerulonephritis
OSBPL7	prostate cancer
OSBPL8	IgA glomerulonephritis
OSBPL9	prostate cancer
OSBPL10	IgA glomerulonephritis
PTPMT1	IgA glomerulonephritis
MB21D1	IgA glomerulonephritis
NT5C3B	stomach cancer
HAUS1	IgA glomerulonephritis
SLC26A7	IgA glomerulonephritis
ZNF554	breast cancer
ATG4A	IgA glomerulonephritis
OMA1	IgA glomerulonephritis
RAB42	IgA glomerulonephritis
SLC25A26	IgA glomerulonephritis
FBXO17	IgA glomerulonephritis
GBP4	IgA glomerulonephritis
GBP5	IgA glomerulonephritis
TBCB	IgA glomerulonephritis
ZNF689	breast cancer
FCHO2	IgA glomerulonephritis
ARHGEF25	IgA glomerulonephritis
SLC5A11	IgA glomerulonephritis
KIR3DL3	IgA glomerulonephritis
NOSTRIN	IgA glomerulonephritis
ARHGAP33	IgA glomerulonephritis
TRMT61A	stomach cancer
RASGRP4	IgA glomerulonephritis
DIS3L	stomach cancer
WDFY2	breast cancer
RAB3C	IgA glomerulonephritis
CKMT1B	prostate cancer
CTHRC1	breast cancer
TSR3	dyskeratosis congenita
CKMT2	prostate cancer
RMI2	breast cancer
SLC22A12	prostate cancer
KLHDC3	prostate cancer
MOGAT1	IgA glomerulonephritis
CKS1B	IgA glomerulonephritis
RBP7	prostate cancer
SLC26A8	IgA glomerulonephritis
LYPD1	IgA glomerulonephritis
IL22RA2	IgA glomerulonephritis
GRIN3A	hypertension
GRIN3B	autistic disorder
TSEN15	stomach cancer
MAS1L	autistic disorder
MRGPRD	hypertension
MRPL53	breast cancer
MRPL54	breast cancer
RPL39L	Diamond-Blackfan anemia
HSPA12B	IgA glomerulonephritis
LEAP2	IgA glomerulonephritis
LRG1	IgA glomerulonephritis
MED12L	breast cancer
ART5	IgA glomerulonephritis
ACAP3	IgA glomerulonephritis
AGAP3	IgA glomerulonephritis
TADA1	breast cancer
CATSPER1	pneumoconiosis
THEM4	IgA glomerulonephritis
CATSPER2	pneumoconiosis
SH2D1B	IgA glomerulonephritis
RAB3IP	Bardet-Biedl syndrome
SLC16A10	prostate cancer
GALNT15	IgA glomerulonephritis
IP6K3	IgA glomerulonephritis
DEFB118	IgA glomerulonephritis
AP2M1	IgA glomerulonephritis
AP2S1	IgA glomerulonephritis
RFFL	IgA glomerulonephritis
AP3S1	IgA glomerulonephritis
ZNF354B	breast cancer
CLCA1	IgA glomerulonephritis
CLCN4	hypertension
UBE2J2	IgA glomerulonephritis
MUCL1	IgA glomerulonephritis
GPR62	IgA glomerulonephritis
EXOSC6	stomach cancer
CHCHD1	breast cancer
CLCN6	IgA glomerulonephritis
PSTK	prostate cancer
PIK3AP1	IgA glomerulonephritis
ZFYVE27	IgA glomerulonephritis
ADD2	prostate cancer
CLIC2	status epilepticus
CLK1	human immunodeficiency virus infectious disease
ANAPC16	IgA glomerulonephritis
PNLIPRP3	IgA glomerulonephritis
CLK2	human immunodeficiency virus infectious disease
OR52E2	endometriosis
OR52J3	endometriosis
OR51L1	endometriosis
OR51A7	endometriosis
OR51S1	endometriosis
OR51F2	endometriosis
OR52R1	IgA glomerulonephritis
OR4C46	endometriosis
OR4X2	endometriosis
OR4B1	endometriosis
OR52M1	endometriosis
OR52K2	endometriosis
OR5P2	endometriosis
OR5P3	endometriosis
LARGE2	IgA glomerulonephritis
CLN5	IgA glomerulonephritis
JAML	IgA glomerulonephritis
OR8I2	endometriosis
OR2D3	endometriosis
OR2D2	endometriosis
OR52W1	endometriosis
OR56A4	endometriosis
OR56A1	endometriosis
CLPS	prostate cancer
CLTA	IgA glomerulonephritis
OR2AP1	endometriosis
OR10P1	endometriosis
CLTB	IgA glomerulonephritis
SDR9C7	retinitis pigmentosa
ZNF641	breast cancer
OR10AD1	endometriosis
CLTC	IgA glomerulonephritis
OR10A7	endometriosis
KRT74	prostate cancer
NEDD1	IgA glomerulonephritis
HIST4H4	IgA glomerulonephritis
ERP27	prostate cancer
FGD4	IgA glomerulonephritis
AEBP2	breast cancer
ALKBH2	IgA glomerulonephritis
CSNK1A1L	breast cancer
TDRD9	prostate cancer
AK7	IgA glomerulonephritis
TRAPPC6B	IgA glomerulonephritis
ADSSL1	IgA glomerulonephritis
RNASE8	IgA glomerulonephritis
MRPL52	breast cancer
PSMB11	human immunodeficiency virus infectious disease
OR4K14	endometriosis
OR4L1	endometriosis
OR11H6	endometriosis
LRR1	IgA glomerulonephritis
FRMD6	IgA glomerulonephritis
SOCS4	IgA glomerulonephritis
NAA30	IgA glomerulonephritis
GPHB5	IgA glomerulonephritis
JDP2	IgA glomerulonephritis
ACOT4	prostate cancer
DEGS2	IgA glomerulonephritis
LEO1	breast cancer
SENP8	IgA glomerulonephritis
TARSL2	IgA glomerulonephritis
NIPA1	prostate cancer
PLA2G4E	IgA glomerulonephritis
ACSM2A	lung benign neoplasm
NRN1L	IgA glomerulonephritis
ADH1A	prostate cancer
CMKLR1	autistic disorder
NOXO1	IgA glomerulonephritis
SEPT12	IgA glomerulonephritis
ZNF720	breast cancer
TMEM219	breast cancer
EARS2	IgA glomerulonephritis
OR4D2	endometriosis
MSI2	IgA glomerulonephritis
CD300LB	IgA glomerulonephritis
KIF19	IgA glomerulonephritis
USP43	IgA glomerulonephritis
B4GALNT2	IgA glomerulonephritis
SLC43A2	IgA glomerulonephritis
GGT6	prostate cancer
MRPL10	breast cancer
TBC1D16	IgA glomerulonephritis
AFMID	obesity
GJD3	hypertension
KRT40	prostate cancer
SLC5A10	IgA glomerulonephritis
INO80C	IgA glomerulonephritis
ZNF543	breast cancer
OR7D4	endometriosis
OR7G1	endometriosis
OR1M1	endometriosis
COX6B2	mitochondrial complex I deficiency
ACER1	IgA glomerulonephritis
ADH1C	prostate cancer
CNGA2	Bardet-Biedl syndrome
TRAPPC5	IgA glomerulonephritis
OSCAR	IgA glomerulonephritis
ZNF441	breast cancer
ZNF440	breast cancer
JOSD2	IgA glomerulonephritis
IZUMO2	pneumoconiosis
CNGA4	Bardet-Biedl syndrome
NLRP5	prostate cancer
ZNF573	breast cancer
TNFAIP8L1	IgA glomerulonephritis
PLK3	IgA glomerulonephritis
LRRC25	prostate cancer
OR1I1	endometriosis
WTIP	IgA glomerulonephritis
ZNF792	breast cancer
NR2C2AP	breast cancer
CNN1	prostate cancer
RINL	IgA glomerulonephritis
FBXO27	IgA glomerulonephritis
OR10H4	endometriosis
RPTN	prostate cancer
CNP	breast cancer
HIST2H3C	IgA glomerulonephritis
SLC44A3	IgA glomerulonephritis
ADH4	prostate cancer
CNTF	IgA glomerulonephritis
OR2M5	endometriosis
OR2M3	endometriosis
OR2T12	endometriosis
OR14C36	endometriosis
OR2T34	endometriosis
OR2T10	endometriosis
OR2T4	endometriosis
OR2T11	IgA glomerulonephritis
CNTFR	IgA glomerulonephritis
ATP6V1G3	IgA glomerulonephritis
ASB17	IgA glomerulonephritis
TYW3	stomach cancer
FAM213B	prostate cancer
DMBX1	breast cancer
OR10J5	endometriosis
ZNF684	breast cancer
RNF19B	IgA glomerulonephritis
A3GALT2	IgA glomerulonephritis
DNAH14	mitochondrial complex I deficiency
OR2AJ1	IgA glomerulonephritis
OR14L1P	IgA glomerulonephritis
OR2B11	endometriosis
ARL8A	IgA glomerulonephritis
SYT2	IgA glomerulonephritis
ADH5	prostate cancer
EDARADD	IgA glomerulonephritis
IQGAP3	IgA glomerulonephritis
NAXE	obesity
ARHGEF19	IgA glomerulonephritis
MRPL55	breast cancer
HIST3H2BB	IgA glomerulonephritis
OR10T2	endometriosis
OR6P1	endometriosis
OR10X1	IgA glomerulonephritis
OR10Z1	endometriosis
OR6K6	endometriosis
OR6N1	endometriosis
FITM2	prostate cancer
COL4A4	IgA glomerulonephritis
COL4A5	IgA glomerulonephritis
COL4A6	IgA glomerulonephritis
BPIFB6	IgA glomerulonephritis
CHMP4B	IgA glomerulonephritis
COL6A2	IgA glomerulonephritis
COL6A3	IgA glomerulonephritis
NUP35	IgA glomerulonephritis
TYW5	stomach cancer
NMS	IgA glomerulonephritis
COL8A2	IgA glomerulonephritis
CMPK2	IgA glomerulonephritis
MBOAT2	IgA glomerulonephritis
TAF8	peripheral nervous system disease
COL9A2	IgA glomerulonephritis
NEU4	IgA glomerulonephritis
AADAC	prostate cancer
ADH6	prostate cancer
OR9A4	endometriosis
REG3G	IgA glomerulonephritis
COL12A1	IgA glomerulonephritis
SGPP2	IgA glomerulonephritis
ACVR1C	breast cancer
LYPD6B	IgA glomerulonephritis
GALM	coronary artery disease
COL16A1	IgA glomerulonephritis
COL17A1	prostate cancer
MTERF4	stomach cancer
COL19A1	IgA glomerulonephritis
KCNH8	autistic disorder
COMP	IgA glomerulonephritis
DNAJC19	IgA glomerulonephritis
TRIM71	IgA glomerulonephritis
CD200R1	IgA glomerulonephritis
CHCHD4	IgA glomerulonephritis
COPB1	IgA glomerulonephritis
UROC1	prostate cancer
SLC31A2	prostate cancer
NUDT16	IgA glomerulonephritis
COL6A6	IgA glomerulonephritis
GRK7	retinitis pigmentosa
IL17RE	IgA glomerulonephritis
RTP1	IgA glomerulonephritis
GLYCTK	prostate cancer
H1FOO	acute myeloid leukemia
PABPC4L	stomach cancer
CORT	IgA glomerulonephritis
ZFP42	breast cancer
LIN54	IgA glomerulonephritis
SPATA18	breast cancer
CPEB2	IgA glomerulonephritis
ENPP6	IgA glomerulonephritis
SLC9B2	hypertension
SETD9	breast cancer
IL31RA	IgA glomerulonephritis
NADK2	IgA glomerulonephritis
UGT3A1	prostate cancer
COX6A1	mitochondrial complex I deficiency
JMY	breast cancer
COX6A2	mitochondrial complex I deficiency
OR2Y1	endometriosis
UBE2QL1	IgA glomerulonephritis
CMBL	prostate cancer
GRPEL2	IgA glomerulonephritis
LSM11	human immunodeficiency virus infectious disease
STARD4	prostate cancer
COX6C	mitochondrial complex I deficiency
ACOT12	obesity
SHROOM1	prostate cancer
COX7A1	mitochondrial complex I deficiency
ADAT2	stomach cancer
COX7A2	mitochondrial complex I deficiency
RIPPLY2	breast cancer
CLVS2	IgA glomerulonephritis
TAAR9	IgA glomerulonephritis
TAAR1	IgA glomerulonephritis
COX7B	mitochondrial complex I deficiency
COX8A	mitochondrial complex I deficiency
NCOA7	prostate cancer
B3GAT2	Ehlers-Danlos syndrome progeroid type
RAET1E	IgA glomerulonephritis
COX11	mitochondrial complex I deficiency
HUS1B	IgA glomerulonephritis
CPA1	IgA glomerulonephritis
CPA2	IgA glomerulonephritis
TRIM50	IgA glomerulonephritis
CPA3	IgA glomerulonephritis
OR9A2	endometriosis
OR2A14	endometriosis
OR6B1	endometriosis
OR2F2	endometriosis
ADORA2B	IgA glomerulonephritis
CPB1	IgA glomerulonephritis
ZNF786	breast cancer
CPD	IgA glomerulonephritis
COL26A1	prostate cancer
MTPN	IgA glomerulonephritis
ASB10	IgA glomerulonephritis
CPN1	prostate cancer
CLDN23	prostate cancer
GOT1L1	lipid storage disease
VPS37A	IgA glomerulonephritis
LYPD2	IgA glomerulonephritis
ADHFE1	prostate cancer
GPAT4	IgA glomerulonephritis
UNC5D	prostate cancer
CARNMT1	prostate cancer
CRABP2	prostate cancer
CRAT	prostate cancer
PTRH1	IgA glomerulonephritis
PIP5KL1	IgA glomerulonephritis
TAF1L	peripheral nervous system disease
ATF2	IgA glomerulonephritis
RPP25L	human immunodeficiency virus infectious disease
OR13C5	IgA glomerulonephritis
ATF6B	IgA glomerulonephritis
OR13C8	endometriosis
OR13C3	endometriosis
OR13C4	endometriosis
OR13F1	endometriosis
OR1L8	endometriosis
OR1N2	endometriosis
OR1N1	IgA glomerulonephritis
AMER1	breast cancer
CRHBP	prostate cancer
APOOL	IgA glomerulonephritis
UPRT	IgA glomerulonephritis
GPR119	prostate cancer
RBMXL3	human immunodeficiency virus infectious disease
DOCK11	IgA glomerulonephritis
AAMP	IgA glomerulonephritis
CRMP1	prostate cancer
RPS4Y2	Diamond-Blackfan anemia
MUC17	IgA glomerulonephritis
ASB11	IgA glomerulonephritis
ASB5	IgA glomerulonephritis
ASB6	IgA glomerulonephritis
ASB7	IgA glomerulonephritis
ASB8	IgA glomerulonephritis
ASB9	IgA glomerulonephritis
MYL6B	IgA glomerulonephritis
DEFB104A	IgA glomerulonephritis
SELENOM	prostate cancer
NEK7	IgA glomerulonephritis
ZFP28	breast cancer
SLC32A1	autistic disorder
GCNT7	IgA glomerulonephritis
TRIM69	IgA glomerulonephritis
BRI3BP	IgA glomerulonephritis
DYNLL2	IgA glomerulonephritis
TMEM37	IgA glomerulonephritis
UBE2F	IgA glomerulonephritis
ADAMTS14	IgA glomerulonephritis
RPL10L	Diamond-Blackfan anemia
TRPM6	IgA glomerulonephritis
KRT72	prostate cancer
SRXN1	prostate cancer
ROMO1	IgA glomerulonephritis
NANP	IgA glomerulonephritis
DEFB127	IgA glomerulonephritis
DEFB129	IgA glomerulonephritis
SIRPA	IgA glomerulonephritis
PABPC5	stomach cancer
SREK1	human immunodeficiency virus infectious disease
CRYBA4	IgA glomerulonephritis
MIB2	breast cancer
DUSP19	IgA glomerulonephritis
SLC34A3	IgA glomerulonephritis
ITLN2	IgA glomerulonephritis
RAB40A	IgA glomerulonephritis
ASB14	IgA glomerulonephritis
ASB12	IgA glomerulonephritis
CRYM	obesity
ACSM6	obesity
SAMD8	Niemann-Pick disease
CRYZ	prostate cancer
LIPJ	prostate cancer
HECTD2	IgA glomerulonephritis
FGFBP3	breast cancer
CSE1L	breast cancer
SYT9	IgA glomerulonephritis
PSMA8	human immunodeficiency virus infectious disease
OR52B4	endometriosis
OR52I2	endometriosis
MUC15	IgA glomerulonephritis
CSF2RA	IgA glomerulonephritis
KDELC2	IgA glomerulonephritis
CSF2RB	IgA glomerulonephritis
CSF3R	IgA glomerulonephritis
OR10A5	IgA glomerulonephritis
OR2AG1	IgA glomerulonephritis
AMDHD1	prostate cancer
SLC2A14	IgA glomerulonephritis
ALG10B	hypertension
ZNF664	breast cancer
CSHL1	IgA glomerulonephritis
CPNE8	IgA glomerulonephritis
BEST3	hypertension
E2F7	IgA glomerulonephritis
KRT80	prostate cancer
FBXL14	IgA glomerulonephritis
CSN2	IgA glomerulonephritis
RAD9B	IgA glomerulonephritis
HNRNPA1L2	human immunodeficiency virus infectious disease
B3GLCT	IgA glomerulonephritis
GSC	breast cancer
CSNK1D	IgA glomerulonephritis
CSNK1E	IgA glomerulonephritis
PTGR2	prostate cancer
CSNK1G2	IgA glomerulonephritis
CSNK1G3	IgA glomerulonephritis
MESP2	breast cancer
NRG4	IgA glomerulonephritis
ADRA1D	IgA glomerulonephritis
OTOA	IgA glomerulonephritis
CMTM2	prostate cancer
FBXL16	IgA glomerulonephritis
CSPG4	IgA glomerulonephritis
ZNF597	breast cancer
ZNF785	breast cancer
ZNF688	breast cancer
CSRP2	breast cancer
TOM1L2	IgA glomerulonephritis
B3GNTL1	IgA glomerulonephritis
CD300LF	IgA glomerulonephritis
RTN4RL1	IgA glomerulonephritis
SLC25A10	prostate cancer
SLC47A2	IgA glomerulonephritis
PIK3R6	IgA glomerulonephritis
CD300LG	IgA glomerulonephritis
KIF18B	IgA glomerulonephritis
EME1	breast cancer
CST2	IgA glomerulonephritis
NOTUM	IgA glomerulonephritis
WIPF2	IgA glomerulonephritis
KRT25	prostate cancer
CST4	IgA glomerulonephritis
CST5	IgA glomerulonephritis
STARD6	prostate cancer
ZNF480	breast cancer
ZNF418	breast cancer
ZNF417	breast cancer
ZNF548	breast cancer
CSTF1	human immunodeficiency virus infectious disease
KLC3	IgA glomerulonephritis
LYPD4	IgA glomerulonephritis
ZNF560	breast cancer
CSTF2	human immunodeficiency virus infectious disease
ZNF563	breast cancer
SPC24	IgA glomerulonephritis
CSTF3	human immunodeficiency virus infectious disease
ZNF420	breast cancer
ZNF565	breast cancer
NLRP4	IgA glomerulonephritis
ZNF582	breast cancer
ZNF583	breast cancer
CAPN12	prostate cancer
ZNF599	breast cancer
ZNF558	breast cancer
CDC42EP5	IgA glomerulonephritis
ZNF738	breast cancer
ZNF714	breast cancer
ZNF681	breast cancer
ATP8B3	IgA glomerulonephritis
ZNF555	breast cancer
ZNF569	breast cancer
ZNF570	breast cancer
CREB3L4	IgA glomerulonephritis
UBE2U	IgA glomerulonephritis
CTBP1	breast cancer
B3GALNT2	IgA glomerulonephritis
LELP1	prostate cancer
CTH	prostate cancer
EXOC8	Bardet-Biedl syndrome
CLDN19	prostate cancer
BPIFB4	IgA glomerulonephritis
AANAT	prostate cancer
CTNND1	prostate cancer
SLC9B1	hypertension
HSCB	IgA glomerulonephritis
CTPS1	IgA glomerulonephritis
NFAM1	IgA glomerulonephritis
PNPLA5	prostate cancer
CTRB1	prostate cancer
SMYD1	breast cancer
CTRL	IgA glomerulonephritis
OR6B3	endometriosis
TTC30B	Bardet-Biedl syndrome
GPAT2	IgA glomerulonephritis
CTSE	IgA glomerulonephritis
CTSG	IgA glomerulonephritis
SGO2	IgA glomerulonephritis
GDF7	breast cancer
CTSV	IgA glomerulonephritis
UPP2	breast cancer
TTC14	breast cancer
DTX3L	IgA glomerulonephritis
BTLA	IgA glomerulonephritis
CTSO	IgA glomerulonephritis
PPP4R2	breast cancer
CTSW	IgA glomerulonephritis
CCDC50	IgA glomerulonephritis
PYDC2	IgA glomerulonephritis
CUX1	IgA glomerulonephritis
CXADR	IgA glomerulonephritis
SH3D19	IgA glomerulonephritis
NIPAL1	prostate cancer
PAQR3	IgA glomerulonephritis
MGAT4D	IgA glomerulonephritis
ZNF595	breast cancer
KLB	IgA glomerulonephritis
PPM1K	prostate cancer
TRMT44	stomach cancer
SLC36A2	IgA glomerulonephritis
SPINK13	prostate cancer
ZMAT2	human immunodeficiency virus infectious disease
MARVELD2	IgA glomerulonephritis
BTNL9	IgA glomerulonephritis
ARSK	IgA glomerulonephritis
CYC1	mitochondrial complex I deficiency
SNRNP48	human immunodeficiency virus infectious disease
SLC2A12	IgA glomerulonephritis
MBOAT1	IgA glomerulonephritis
RNF217	IgA glomerulonephritis
ABCA13	IgA glomerulonephritis
AMOT	IgA glomerulonephritis
VKORC1L1	multiple system atrophy
AMOTL1	IgA glomerulonephritis
KCTD7	IgA glomerulonephritis
CYP2A7	prostate cancer
ZNF425	breast cancer
ZNF746	breast cancer
ATP6V0E2	IgA glomerulonephritis
CYP3A7	prostate cancer
SLC2A7	IgA glomerulonephritis
VPS37D	IgA glomerulonephritis
CYP2D7	prostate cancer
CYP2F1	prostate cancer
CYP2J2	prostate cancer
RDH10	prostate cancer
TDH	prostate cancer
CLVS1	IgA glomerulonephritis
KCNU1	pneumoconiosis
SBSPON	IgA glomerulonephritis
CYP4A11	prostate cancer
AK8	IgA glomerulonephritis
EEF1A1P5	Diamond-Blackfan anemia
OR1Q1	endometriosis
ZNF483	breast cancer
ZNF782	breast cancer
ZNF645	IgA glomerulonephritis
MOSPD2	IgA glomerulonephritis
ARHGAP36	IgA glomerulonephritis
AWAT1	prostate cancer
AWAT2	prostate cancer
CYP21A2	prostate cancer
H2BFWT	IgA glomerulonephritis
CYP51A1	porokeratosis
SLC5A12	IgA glomerulonephritis
AP2A1	IgA glomerulonephritis
DAB2	IgA glomerulonephritis
LDHAL6A	obesity
DAD1	IgA glomerulonephritis
ALDH1L2	prostate cancer
DENND5B	IgA glomerulonephritis
DGKA	IgA glomerulonephritis
GRASP	IgA glomerulonephritis
DGKG	IgA glomerulonephritis
STOML3	hypertension
FITM1	prostate cancer
DAPK3	breast cancer
DARS	IgA glomerulonephritis
ADAL	IgA glomerulonephritis
ZFPM1	IgA glomerulonephritis
AP1B1	IgA glomerulonephritis
DBI	prostate cancer
ZFP1	breast cancer
NAGS	prostate cancer
PHOSPHO1	IgA glomerulonephritis
TRPV3	hypertension
KRT28	prostate cancer
ZNF519	breast cancer
TCEB3C	peripheral nervous system disease
DBP	chronic myeloid leukemia
ZNF610	breast cancer
ZNF600	breast cancer
ZNF320	breast cancer
ZNF550	breast cancer
DEDD2	IgA glomerulonephritis
OR7D2	endometriosis
AP2B1	IgA glomerulonephritis
ZNF791	breast cancer
ZNF564	breast cancer
ZNF709	breast cancer
ZNF114	breast cancer
ZNF567	breast cancer
ZNF383	breast cancer
EID2	IgA glomerulonephritis
LGI4	autistic disorder
ECI1	obesity
ZNF100	breast cancer
ZNF540	breast cancer
DENND2C	IgA glomerulonephritis
PLPPR5	IgA glomerulonephritis
DCTD	IgA glomerulonephritis
CALML6	IgA glomerulonephritis
CITED4	breast cancer
DCT	tyrosinemia
AP1G1	IgA glomerulonephritis
DCX	breast cancer
DDB2	IgA glomerulonephritis
LRRN4	autistic disorder
APOBEC3H	breast cancer
DDOST	IgA glomerulonephritis
OXER1	IgA glomerulonephritis
SPTSSB	IgA glomerulonephritis
GPR156	autistic disorder
DHX8	human immunodeficiency virus infectious disease
RNF168	IgA glomerulonephritis
DHX9	IgA glomerulonephritis
CHST13	Ehlers-Danlos syndrome progeroid type
DDX11	prostate cancer
DEFA1	IgA glomerulonephritis
MMAA	obesity
RASSF6	IgA glomerulonephritis
DEFA4	IgA glomerulonephritis
SGMS2	IgA glomerulonephritis
CDC20B	IgA glomerulonephritis
UGT3A2	prostate cancer
DCP2	stomach cancer
DFFA	IgA glomerulonephritis
DFFB	IgA glomerulonephritis
TIMM8A	IgA glomerulonephritis
OLIG3	breast cancer
ZNF92	breast cancer
GALNTL5	IgA glomerulonephritis
ZNF679	breast cancer
BHLHA15	type 2 diabetes mellitus
IDO2	obesity
KCNV2	autistic disorder
ZNF169	breast cancer
ZCCHC12	breast cancer
CLEC4C	IgA glomerulonephritis
DHX36	IgA glomerulonephritis
NUDT10	IgA glomerulonephritis
ADAMTS15	IgA glomerulonephritis
ADAMTS16	IgA glomerulonephritis
ADAMTS18	IgA glomerulonephritis
COX7B2	mitochondrial complex I deficiency
KCNG3	autistic disorder
PPP1R18	IgA glomerulonephritis
ZNF431	breast cancer
ZNF721	breast cancer
SPACA4	IgA glomerulonephritis
RHOV	IgA glomerulonephritis
NLRP6	IgA glomerulonephritis
ZNF675	breast cancer
SPTSSA	IgA glomerulonephritis
POLR3H	Treacher Collins syndrome
ABHD3	IgA glomerulonephritis
DGUOK	breast cancer
DHPS	IgA glomerulonephritis
DIAPH1	IgA glomerulonephritis
DIAPH2	IgA glomerulonephritis
SEPT1	IgA glomerulonephritis
DIO3	prostate cancer
DLG3	autistic disorder
DLST	obesity
DLX5	breast cancer
DLX6	breast cancer
SARDH	prostate cancer
DMP1	prostate cancer
DNM1	IgA glomerulonephritis
DNA2	IgA glomerulonephritis
DNAH9	mitochondrial complex I deficiency
DNASE1L1	IgA glomerulonephritis
DNASE2	IgA glomerulonephritis
DYNC1I2	IgA glomerulonephritis
DYNC1LI2	IgA glomerulonephritis
TRDMT1	stomach cancer
DNTT	IgA glomerulonephritis
DOCK3	IgA glomerulonephritis
DPEP1	prostate cancer
DPH1	IgA glomerulonephritis
DPH2	IgA glomerulonephritis
DPYS	breast cancer
DPYSL3	prostate cancer
DR1	breast cancer
ARID3A	breast cancer
DSG3	prostate cancer
DTYMK	IgA glomerulonephritis
DUSP2	IgA glomerulonephritis
DUSP4	IgA glomerulonephritis
DUSP5	IgA glomerulonephritis
DUSP7	IgA glomerulonephritis
DUSP8	IgA glomerulonephritis
DUSP9	IgA glomerulonephritis
DUT	IgA glomerulonephritis
DVL1	breast cancer
DVL2	breast cancer
DVL3	breast cancer
APLNR	IgA glomerulonephritis
E2F2	IgA glomerulonephritis
E2F3	IgA glomerulonephritis
E2F4	IgA glomerulonephritis
E2F5	IgA glomerulonephritis
E2F6	IgA glomerulonephritis
E4F1	breast cancer
AGXT	prostate cancer
ECH1	obesity
NR0B1	breast cancer
S1PR1	IgA glomerulonephritis
S1PR3	IgA glomerulonephritis
EDN2	IgA glomerulonephritis
PHC2	IgA glomerulonephritis
PGAM5	IgA glomerulonephritis
B3GNT6	IgA glomerulonephritis
KRT24	prostate cancer
AGO3	IgA glomerulonephritis
AGO4	IgA glomerulonephritis
EEF1D	Diamond-Blackfan anemia
EEF1G	Diamond-Blackfan anemia
EFNA2	IgA glomerulonephritis
EFNA3	IgA glomerulonephritis
EFNA4	IgA glomerulonephritis
EFNA5	IgA glomerulonephritis
EFNB3	IgA glomerulonephritis
CELSR3	IgA glomerulonephritis
SDR16C5	prostate cancer
EGR3	IgA glomerulonephritis
EGR4	IgA glomerulonephritis
OR56B4	endometriosis
KRT78	prostate cancer
DNAH10	mitochondrial complex I deficiency
EEF2KMT	IgA glomerulonephritis
DCP1B	stomach cancer
ARID2	breast cancer
EIF2B1	Diamond-Blackfan anemia
EIF2S3	Diamond-Blackfan anemia
ADCY4	IgA glomerulonephritis
LDHD	obesity
FUK	IgA glomerulonephritis
MLKL	prostate cancer
ZNF778	breast cancer
ACSF3	obesity
EME2	breast cancer
NLRC3	IgA glomerulonephritis
NSMCE1	IgA glomerulonephritis
EIF4A2	Diamond-Blackfan anemia
EIF4B	Diamond-Blackfan anemia
EIF4E	breast cancer
EIF4EBP2	breast cancer
EIF4G1	breast cancer
EIF4G2	IgA glomerulonephritis
EIF5	Diamond-Blackfan anemia
EIF5A	IgA glomerulonephritis
SERPINB1	IgA glomerulonephritis
MCEMP1	IgA glomerulonephritis
ZNF627	breast cancer
DAND5	holoprosencephaly
ZNF585A	breast cancer
U2AF1L4	human immunodeficiency virus infectious disease
ZNF626	breast cancer
ELF2	IgA glomerulonephritis
LCE4A	prostate cancer
ALG14	IgA glomerulonephritis
CYP4Z1	prostate cancer
FAAP20	IgA glomerulonephritis
ABCA2	IgA glomerulonephritis
ELF4	IgA glomerulonephritis
SLC5A9	IgA glomerulonephritis
TXLNA	IgA glomerulonephritis
ELF5	IgA glomerulonephritis
CRTC2	IgA glomerulonephritis
ELK1	IgA glomerulonephritis
APOBEC3F	IgA glomerulonephritis
CREG2	prostate cancer
TET3	breast cancer
ELK4	breast cancer
APLF	hypertension
KCTD6	IgA glomerulonephritis
ARL13B	Bardet-Biedl syndrome
DHFR2	prostate cancer
HTR3D	autistic disorder
RPL22L1	Diamond-Blackfan anemia
FBXO45	IgA glomerulonephritis
MUC20	IgA glomerulonephritis
GABRR3	autistic disorder
PLD6	IgA glomerulonephritis
ARHGAP27	IgA glomerulonephritis
CENPX	IgA glomerulonephritis
UNC13D	IgA glomerulonephritis
FBXO15	IgA glomerulonephritis
ADGRE1	IgA glomerulonephritis
ZNF584	breast cancer
ZSCAN4	prostate cancer
HACD2	obesity
STT3B	IgA glomerulonephritis
DENND6A	IgA glomerulonephritis
TIGIT	prostate cancer
CTTN	IgA glomerulonephritis
ENDOG	breast cancer
GAPT	IgA glomerulonephritis
ENPEP	IgA glomerulonephritis
TUBB	IgA glomerulonephritis
LGI3	autistic disorder
NRK	obesity
EPB41L1	autistic disorder
EPB41L2	autistic disorder
ANO5	hypertension
DMTN	prostate cancer
STOM	IgA glomerulonephritis
EPHA3	IgA glomerulonephritis
EPHA4	breast cancer
EPHA5	IgA glomerulonephritis
EPHA8	IgA glomerulonephritis
EPHB1	IgA glomerulonephritis
HIPK1	breast cancer
EPHB3	IgA glomerulonephritis
SLC44A5	IgA glomerulonephritis
AK4	IgA glomerulonephritis
EPHB6	IgA glomerulonephritis
CLN8	autistic disorder
SENP5	IgA glomerulonephritis
EPRS	prostate cancer
EPS8	IgA glomerulonephritis
EPS15	IgA glomerulonephritis
SLC36A1	prostate cancer
EYA4	breast cancer
ERCC5	IgA glomerulonephritis
ESD	prostate cancer
ABCA3	prostate cancer
ESRRB	breast cancer
ESRRG	breast cancer
ETF1	Diamond-Blackfan anemia
ETV3	breast cancer
EVPL	prostate cancer
EXTL1	Ehlers-Danlos syndrome progeroid type
EXTL2	Ehlers-Danlos syndrome progeroid type
EXTL3	Ehlers-Danlos syndrome progeroid type
EYA2	breast cancer
ALCAM	prostate cancer
EYA3	breast cancer
EZH1	breast cancer
F2RL2	IgA glomerulonephritis
FABP2	prostate cancer
FABP6	prostate cancer
ALDH3A1	prostate cancer
ACSL3	obesity
FARSA	tyrosinemia
USP12	IgA glomerulonephritis
MTIF3	breast cancer
OR8U1	endometriosis
OR4C16	IgA glomerulonephritis
OR4C11	endometriosis
OR4S2	endometriosis
OR4C6	endometriosis
OR5D14	endometriosis
OR5L1	IgA glomerulonephritis
OR5D18	endometriosis
OR5AS1	endometriosis
OR8K5	endometriosis
OR5T2	endometriosis
OR8H1	endometriosis
OR8K3	IgA glomerulonephritis
OR8J1	endometriosis
OR5R1	IgA glomerulonephritis
OR5M3	endometriosis
OR5M8	endometriosis
OR5M11	endometriosis
OR5AR1	endometriosis
MED19	prostate cancer
ZNF804B	breast cancer
FOLH1B	prostate cancer
UNC5B	prostate cancer
FAU	Diamond-Blackfan anemia
ZNF25	breast cancer
SLC37A2	prostate cancer
OR8B12	endometriosis
OR8G5	IgA glomerulonephritis
OR10G8	endometriosis
OR10G9	endometriosis
OR10S1	endometriosis
OR6T1	endometriosis
OR4D5	endometriosis
FBLN2	prostate cancer
MRPL21	breast cancer
TPCN2	IgA glomerulonephritis
OR6Q1	IgA glomerulonephritis
OR9I1	endometriosis
OR9Q1	endometriosis
OR9Q2	endometriosis
OR1S2	endometriosis
OR1S1	IgA glomerulonephritis
OR10Q1	endometriosis
OR5B17	endometriosis
OR5B21	endometriosis
GLYATL2	lung benign neoplasm
MPEG1	IgA glomerulonephritis
OR5A2	endometriosis
OR5A1	endometriosis
OR4D6	endometriosis
OR4D11	endometriosis
PATL1	stomach cancer
LRTOMT	Sjogren-Larsson syndrome
FBN2	prostate cancer
SKA1	IgA glomerulonephritis
FCAR	IgA glomerulonephritis
RNF152	IgA glomerulonephritis
FCER1A	IgA glomerulonephritis
MS4A2	IgA glomerulonephritis
FCER1G	IgA glomerulonephritis
SLC16A9	IgA glomerulonephritis
HNRNPA3	human immunodeficiency virus infectious disease
ZNF485	breast cancer
ALDH3B1	prostate cancer
FCGR1B	IgA glomerulonephritis
NSUN6	stomach cancer
ALKBH3	IgA glomerulonephritis
EEF1AKMT1	IgA glomerulonephritis
SPATA13	IgA glomerulonephritis
CES5A	prostate cancer
AK9	IgA glomerulonephritis
OPN5	IgA glomerulonephritis
ADGRF4	prostate cancer
ADGRF5	IgA glomerulonephritis
TDRD6	prostate cancer
FGD2	IgA glomerulonephritis
LEMD2	IgA glomerulonephritis
HIST1H2AA	IgA glomerulonephritis
KDM1B	IgA glomerulonephritis
ZSCAN25	breast cancer
PRPS1L1	IgA glomerulonephritis
TWISTNB	breast cancer
FCN1	IgA glomerulonephritis
GPC2	IgA glomerulonephritis
FOXK1	IgA glomerulonephritis
DAGLB	IgA glomerulonephritis
CCZ1B	IgA glomerulonephritis
THSD7A	IgA glomerulonephritis
ALDH3B2	prostate cancer
FCN2	IgA glomerulonephritis
NAPEPLD	prostate cancer
ADGRG3	IgA glomerulonephritis
GPRC6A	IgA glomerulonephritis
UNC5CL	IgA glomerulonephritis
SLC29A4	prostate cancer
ALDH9A1	prostate cancer
FDX1	prostate cancer
ZNRF2	IgA glomerulonephritis
FDXR	prostate cancer
FEN1	IgA glomerulonephritis
FER	IgA glomerulonephritis
ABCD2	prostate cancer
FGF5	breast cancer
FGF6	breast cancer
FGF11	breast cancer
FGF12	breast cancer
FGR	IgA glomerulonephritis
FH	obesity
FHL1	breast cancer
VEGFD	IgA glomerulonephritis
CASC3	human immunodeficiency virus infectious disease
NID2	prostate cancer
COG2	IgA glomerulonephritis
LAMB4	IgA glomerulonephritis
ITGA11	IgA glomerulonephritis
XRN2	stomach cancer
ATF5	IgA glomerulonephritis
FKBP1B	IgA glomerulonephritis
COPZ1	IgA glomerulonephritis
COPG1	IgA glomerulonephritis
RASA3	IgA glomerulonephritis
MTF2	breast cancer
HSPA4L	IgA glomerulonephritis
DNAJC8	human immunodeficiency virus infectious disease
NLGN4Y	autistic disorder
CEP162	Bardet-Biedl syndrome
ZFP30	breast cancer
RHOBTB3	IgA glomerulonephritis
DLGAP4	autistic disorder
DOLK	IgA glomerulonephritis
AAK1	IgA glomerulonephritis
CPEB3	IgA glomerulonephritis
CHSY1	Ehlers-Danlos syndrome progeroid type
ADGRL1	lung disease
NLRP1	IgA glomerulonephritis
FNDC3A	IgA glomerulonephritis
ATG14	IgA glomerulonephritis
CNKSR2	IgA glomerulonephritis
ZNF510	breast cancer
FKBP3	IgA glomerulonephritis
PPP6R1	IgA glomerulonephritis
SEC31A	IgA glomerulonephritis
DZIP1	IgA glomerulonephritis
ENPP4	IgA glomerulonephritis
MLXIP	IgA glomerulonephritis
TRAPPC8	IgA glomerulonephritis
MON1B	IgA glomerulonephritis
FKBP4	prostate cancer
ABLIM3	IgA glomerulonephritis
UBOX5	IgA glomerulonephritis
DIS3	stomach cancer
RPH3A	IgA glomerulonephritis
CEP164	IgA glomerulonephritis
DENND3	IgA glomerulonephritis
ARHGEF15	IgA glomerulonephritis
ARSG	IgA glomerulonephritis
EPN2	IgA glomerulonephritis
TRAK1	IgA glomerulonephritis
SACM1L	IgA glomerulonephritis
FAN1	IgA glomerulonephritis
MMRN1	IgA glomerulonephritis
NCBP2	human immunodeficiency virus infectious disease
ZP1	pneumoconiosis
CD93	IgA glomerulonephritis
MSRB2	prostate cancer
HABP4	IgA glomerulonephritis
SEPHS2	prostate cancer
SEPHS1	prostate cancer
SIRT2	obesity
RPIA	IgA glomerulonephritis
ELL2	IgA glomerulonephritis
SCAP	prostate cancer
SNW1	breast cancer
KIN	IgA glomerulonephritis
PTGR1	prostate cancer
CYP2G1P	prostate cancer
SCMH1	IgA glomerulonephritis
FOXD1	prostate cancer
AKR7A3	prostate cancer
NT5C2	breast cancer
NINL	IgA glomerulonephritis
PDCD11	dyskeratosis congenita
ACIN1	IgA glomerulonephritis
SV2C	kidney disease
MYH15	prostate cancer
KDM2A	obesity
CEP131	IgA glomerulonephritis
ALDOC	IgA glomerulonephritis
FOXL1	breast cancer
DAAM1	IgA glomerulonephritis
PLCH1	IgA glomerulonephritis
RAB21	IgA glomerulonephritis
SPEN	breast cancer
FBXO21	IgA glomerulonephritis
EXOSC7	stomach cancer
FAIM2	IgA glomerulonephritis
CNOT1	stomach cancer
USP33	IgA glomerulonephritis
XPO7	IgA glomerulonephritis
PDS5B	IgA glomerulonephritis
FNBP1	IgA glomerulonephritis
SMG1	Diamond-Blackfan anemia
ENDOD1	IgA glomerulonephritis
CLUAP1	Bardet-Biedl syndrome
GGA2	IgA glomerulonephritis
SETD1B	breast cancer
CMTR1	peripheral nervous system disease
PPRC1	breast cancer
EXPH5	IgA glomerulonephritis
TRIM35	Down syndrome
PEG10	IgA glomerulonephritis
ZNF423	breast cancer
SIPA1L3	breast cancer
IQSEC2	IgA glomerulonephritis
CDK19	prostate cancer
MRPS27	breast cancer
NFASC	IgA glomerulonephritis
TAB2	IgA glomerulonephritis
ATP10B	autistic disorder
CLASP2	IgA glomerulonephritis
COLGALT2	IgA glomerulonephritis
PHF8	IgA glomerulonephritis
SMC5	IgA glomerulonephritis
ANKLE2	IgA glomerulonephritis
SSPO	IgA glomerulonephritis
FCHO1	IgA glomerulonephritis
GRAMD4	IgA glomerulonephritis
SEPT6	IgA glomerulonephritis
WDR43	dyskeratosis congenita
GGA3	IgA glomerulonephritis
STAB1	IgA glomerulonephritis
RTF1	peripheral nervous system disease
SLC35D1	prostate cancer
FAM175B	IgA glomerulonephritis
METAP1	retinitis pigmentosa
LPIN1	IgA glomerulonephritis
SEPT8	IgA glomerulonephritis
RGL1	prostate cancer
FLNC	prostate cancer
DIP2A	breast cancer
MESDC2	breast cancer
FLOT2	IgA glomerulonephritis
CYFIP1	IgA glomerulonephritis
ATG4B	IgA glomerulonephritis
GANAB	IgA glomerulonephritis
MDN1	dyskeratosis congenita
ATP11B	IgA glomerulonephritis
PMPCA	IgA glomerulonephritis
ACSBG1	obesity
PLEKHM2	IgA glomerulonephritis
SYT11	IgA glomerulonephritis
JMJD6	breast cancer
NBEAL2	IgA glomerulonephritis
NUP210	IgA glomerulonephritis
ARHGEF9	IgA glomerulonephritis
FLT3LG	IgA glomerulonephritis
SIK2	IgA glomerulonephritis
PHLPP1	IgA glomerulonephritis
ANKRD28	IgA glomerulonephritis
RPRD2	IgA glomerulonephritis
KAZN	prostate cancer
SCFD1	IgA glomerulonephritis
DENND5A	IgA glomerulonephritis
FMO1	prostate cancer
CAMTA1	IgA glomerulonephritis
PPIP5K2	IgA glomerulonephritis
MCF2L	IgA glomerulonephritis
EXOC7	breast cancer
ADGRL2	hypertension
DNMBP	IgA glomerulonephritis
POFUT2	IgA glomerulonephritis
CLUH	Diamond-Blackfan anemia
NUP160	IgA glomerulonephritis
CSTF2T	human immunodeficiency virus infectious disease
ADGRL3	hypertension
WWC1	IgA glomerulonephritis
AGTPBP1	autistic disorder
IQCE	IgA glomerulonephritis
FMO4	prostate cancer
FBXW11	IgA glomerulonephritis
MGRN1	IgA glomerulonephritis
BICD2	IgA glomerulonephritis
FMO5	prostate cancer
ATMIN	IgA glomerulonephritis
KIF13B	IgA glomerulonephritis
UBR2	IgA glomerulonephritis
ACSL6	obesity
SIN3B	prostate cancer
FMOD	IgA glomerulonephritis
NCAPD3	IgA glomerulonephritis
SLC9A8	IgA glomerulonephritis
MAN2B2	IgA glomerulonephritis
KIAA1033	IgA glomerulonephritis
USP22	IgA glomerulonephritis
CLASP1	IgA glomerulonephritis
JADE2	breast cancer
ESYT1	IgA glomerulonephritis
DOCK9	IgA glomerulonephritis
U2SURP	human immunodeficiency virus infectious disease
UBR4	IgA glomerulonephritis
HAUS5	IgA glomerulonephritis
USP24	IgA glomerulonephritis
PPP1R13B	breast cancer
ARHGEF18	IgA glomerulonephritis
TNS2	IgA glomerulonephritis
UFL1	IgA glomerulonephritis
RRP8	breast cancer
ICE1	IgA glomerulonephritis
SRGAP2	IgA glomerulonephritis
SMG5	IgA glomerulonephritis
SIK3	breast cancer
MED13L	breast cancer
FNTA	retinitis pigmentosa
ZDHHC17	IgA glomerulonephritis
LARS2	IgA glomerulonephritis
PIP5K1C	IgA glomerulonephritis
NCAPH	IgA glomerulonephritis
PPWD1	human immunodeficiency virus infectious disease
CTDNEP1	IgA glomerulonephritis
FRAT2	breast cancer
SIRT5	obesity
SIRT4	obesity
COMMD3	IgA glomerulonephritis
KCNH4	autistic disorder
KCNH3	autistic disorder
MLYCD	obesity
FNTB	retinitis pigmentosa
TMED3	IgA glomerulonephritis
GRIP1	autistic disorder
RYBP	IgA glomerulonephritis
AP4E1	IgA glomerulonephritis
GPR161	IgA glomerulonephritis
RHOQ	IgA glomerulonephritis
HARS2	IgA glomerulonephritis
ATP1B4	IgA glomerulonephritis
SLC35A3	IgA glomerulonephritis
SLC44A1	IgA glomerulonephritis
SF3B3	human immunodeficiency virus infectious disease
ABCB10	sideroblastic anemia
ABCB9	IgA glomerulonephritis
ABCA5	prostate cancer
GCAT	prostate cancer
CBX6	IgA glomerulonephritis
CBX5	IgA glomerulonephritis
CAPN7	prostate cancer
QPRT	obesity
SEC11A	obesity
ISCU	Friedreich ataxia
SEC61G	prostate cancer
MACF1	breast cancer
FOLR2	IgA glomerulonephritis
DAAM2	breast cancer
POFUT1	IgA glomerulonephritis
NUP188	IgA glomerulonephritis
SCRIB	breast cancer
SPIDR	breast cancer
SLC39A14	IgA glomerulonephritis
SKIV2L2	stomach cancer
FOLR3	IgA glomerulonephritis
RPL13A	Diamond-Blackfan anemia
CABIN1	IgA glomerulonephritis
SRRM2	human immunodeficiency virus infectious disease
ACAP2	IgA glomerulonephritis
ZNF281	breast cancer
PIK3R5	IgA glomerulonephritis
ADAT1	stomach cancer
OR52A1	endometriosis
SEC14L2	breast cancer
MAPK8IP2	IgA glomerulonephritis
ATP6V0A2	IgA glomerulonephritis
PSD4	IgA glomerulonephritis
HYAL4	IgA glomerulonephritis
PIGN	breast cancer
SNAPIN	IgA glomerulonephritis
WBP2	IgA glomerulonephritis
GTPBP4	dyskeratosis congenita
LPAR3	IgA glomerulonephritis
FPR1	IgA glomerulonephritis
FPR2	IgA glomerulonephritis
CASP14	prostate cancer
SMUG1	autistic disorder
ELP5	breast cancer
CARHSP1	IgA glomerulonephritis
PDSS1	multiple system atrophy
ORC3	Meier-Gorlin syndrome
OPN3	IgA glomerulonephritis
ACOT9	prostate cancer
PATZ1	prostate cancer
DAPK2	breast cancer
MKRN1	IgA glomerulonephritis
MKRN2	prostate cancer
NTSR2	IgA glomerulonephritis
RUSC1	breast cancer
CBLC	IgA glomerulonephritis
SPO11	IgA glomerulonephritis
PRND	IgA glomerulonephritis
KCNE5	hypertension
CA14	obesity
KPNA6	IgA glomerulonephritis
NUP62	IgA glomerulonephritis
RABGAP1	IgA glomerulonephritis
HSPBP1	prostate cancer
PPP1R15A	IgA glomerulonephritis
PLD3	IgA glomerulonephritis
ARFIP2	IgA glomerulonephritis
POLA2	IgA glomerulonephritis
TRIM29	IgA glomerulonephritis
PLXNB2	IgA glomerulonephritis
PLA2G15	IgA glomerulonephritis
ZKSCAN5	breast cancer
STX12	IgA glomerulonephritis
SH3BP4	IgA glomerulonephritis
SGK3	IgA glomerulonephritis
RAB38	IgA glomerulonephritis
KCNE4	hypertension
GSPT2	Diamond-Blackfan anemia
GABARAPL1	IgA glomerulonephritis
PPIL2	IgA glomerulonephritis
PITPNB	IgA glomerulonephritis
PISD	IgA glomerulonephritis
MAFF	IgA glomerulonephritis
GABARAPL3	IgA glomerulonephritis
FLRT2	breast cancer
FLRT1	breast cancer
FKBP8	IgA glomerulonephritis
ARHGAP8	IgA glomerulonephritis
BCL2L13	prostate cancer
PANX1	hypertension
CLDN15	prostate cancer
ZNF318	prostate cancer
SPDYA	IgA glomerulonephritis
DEFB105A	IgA glomerulonephritis
DEFB106A	IgA glomerulonephritis
DEFB107A	IgA glomerulonephritis
DEFB108B	IgA glomerulonephritis
DEFB109P1	IgA glomerulonephritis
DEFB110	IgA glomerulonephritis
DEFB112	IgA glomerulonephritis
DEFB113	IgA glomerulonephritis
DEFB114	IgA glomerulonephritis
DEFB115	IgA glomerulonephritis
DEFB116	IgA glomerulonephritis
DEFB119	IgA glomerulonephritis
DEFB121	IgA glomerulonephritis
DEFB123	IgA glomerulonephritis
DEFB124	IgA glomerulonephritis
DEFB125	IgA glomerulonephritis
DEFB128	IgA glomerulonephritis
DEFB130	IgA glomerulonephritis
ATP6V1C2	IgA glomerulonephritis
CNOT6L	stomach cancer
AKR7L	prostate cancer
CDC26	IgA glomerulonephritis
SLC17A8	autistic disorder
RNASEH1	Meier-Gorlin syndrome
PELI3	IgA glomerulonephritis
POLR2J2	IgA glomerulonephritis
ALOX15B	prostate cancer
ALPI	prostate cancer
FRZB	breast cancer
CENPI	IgA glomerulonephritis
ALPP	IgA glomerulonephritis
ALPPL2	IgA glomerulonephritis
ADAM2	pneumoconiosis
FUCA2	IgA glomerulonephritis
FUT1	IgA glomerulonephritis
FUT3	IgA glomerulonephritis
FUT5	IgA glomerulonephritis
NEIL2	autistic disorder
FUT8	IgA glomerulonephritis
KDSR	IgA glomerulonephritis
EIF4E1B	IgA glomerulonephritis
LCLAT1	IgA glomerulonephritis
ZNF620	breast cancer
FAM21C	IgA glomerulonephritis
EBF3	breast cancer
MSRB3	prostate cancer
RALGAPA1	breast cancer
SFTA3	IgA glomerulonephritis
ETFBKMT	IgA glomerulonephritis
SNX32	IgA glomerulonephritis
SLC37A4	IgA glomerulonephritis
MCM9	IgA glomerulonephritis
LPCAT4	IgA glomerulonephritis
XRCC6	IgA glomerulonephritis
OR6C74	endometriosis
OR6C3	endometriosis
OR2T6	endometriosis
LCE5A	prostate cancer
OR1L4	endometriosis
MPV17L	Zellweger syndrome
TMEM86B	IgA glomerulonephritis
TAC4	IgA glomerulonephritis
PLA2G4F	IgA glomerulonephritis
MCOLN2	hypertension
ZNF718	breast cancer
RNF144B	IgA glomerulonephritis
HIST1H2BA	IgA glomerulonephritis
COL24A1	IgA glomerulonephritis
OR52B2	endometriosis
NPNT	IgA glomerulonephritis
GABRA6	autistic disorder
CNEP1R1	IgA glomerulonephritis
PAN3	stomach cancer
ZNF549	breast cancer
COL6A5	IgA glomerulonephritis
GABRB2	autistic disorder
OR4C3	endometriosis
OR4S1	endometriosis
NUDT14	IgA glomerulonephritis
GK5	coronary artery disease
GABRE	autistic disorder
ST6GALNAC3	IgA glomerulonephritis
MFSD8	IgA glomerulonephritis
GABRG1	autistic disorder
GABRP	autistic disorder
GABRR1	autistic disorder
SERINC5	prostate cancer
CATSPERD	pneumoconiosis
UTS2B	IgA glomerulonephritis
SNX33	IgA glomerulonephritis
TAB3	IgA glomerulonephritis
SHC2	IgA glomerulonephritis
PRPF40B	human immunodeficiency virus infectious disease
SLC24A2	IgA glomerulonephritis
CBY1	breast cancer
NGEF	IgA glomerulonephritis
FBXO7	IgA glomerulonephritis
BRI3	IgA glomerulonephritis
ZNF324	breast cancer
GCA	IgA glomerulonephritis
SVIP	IgA glomerulonephritis
LSM4	human immunodeficiency virus infectious disease
BAMBI	IgA glomerulonephritis
VAX2	breast cancer
SAMM50	IgA glomerulonephritis
NOCT	chronic myeloid leukemia
ARIH1	IgA glomerulonephritis
B4GALNT1	IgA glomerulonephritis
HECTD1	IgA glomerulonephritis
POU2F3	IgA glomerulonephritis
MGAT4C	IgA glomerulonephritis
RAB26	IgA glomerulonephritis
COG4	IgA glomerulonephritis
ANAPC13	IgA glomerulonephritis
BRMS1	breast cancer
USP49	IgA glomerulonephritis
GALR1	IgA glomerulonephritis
SUMF2	IgA glomerulonephritis
RPL36	Diamond-Blackfan anemia
MPC2	obesity
DCAF13	dyskeratosis congenita
POLR1A	breast cancer
ZNF473	human immunodeficiency virus infectious disease
INTS7	IgA glomerulonephritis
RNF19A	IgA glomerulonephritis
RCHY1	IgA glomerulonephritis
CNOT10	stomach cancer
ANAPC15	IgA glomerulonephritis
AHCTF1	IgA glomerulonephritis
ALS2CL	IgA glomerulonephritis
NELFB	peripheral nervous system disease
ZDHHC5	IgA glomerulonephritis
LY6G6F	IgA glomerulonephritis
SGMS1	IgA glomerulonephritis
NALCN	hypertension
MYRIP	IgA glomerulonephritis
NOL11	dyskeratosis congenita
SOSTDC1	prostate cancer
TAS2R39	autistic disorder
TAS2R40	autistic disorder
TAS2R41	autistic disorder
TAS2R43	autistic disorder
GEMIN5	human immunodeficiency virus infectious disease
TAS2R31	autistic disorder
TAS2R45	autistic disorder
TAS2R46	autistic disorder
TAS2R30	autistic disorder
TAS2R19	autistic disorder
TAS2R20	autistic disorder
TAS2R50	autistic disorder
PTPN23	IgA glomerulonephritis
IL4I1	prostate cancer
NSL1	IgA glomerulonephritis
SIN3A	IgA glomerulonephritis
NECTIN3	prostate cancer
ZNF385A	IgA glomerulonephritis
SYF2	human immunodeficiency virus infectious disease
GANC	IgA glomerulonephritis
RWDD3	IgA glomerulonephritis
SEC31B	prostate cancer
ADGRA2	IgA glomerulonephritis
NUDT13	IgA glomerulonephritis
TMEM87A	IgA glomerulonephritis
PARS2	IgA glomerulonephritis
MMACHC	prostate cancer
NECAP1	IgA glomerulonephritis
KRT23	prostate cancer
TSKU	breast cancer
ULK3	IgA glomerulonephritis
REXO2	dyskeratosis congenita
IBTK	IgA glomerulonephritis
CLIP3	IgA glomerulonephritis
TBC1D10B	IgA glomerulonephritis
GORASP2	IgA glomerulonephritis
TKFC	IgA glomerulonephritis
L3MBTL1	breast cancer
LRIG1	IgA glomerulonephritis
LRP10	prostate cancer
ACOT11	prostate cancer
CYP4X1	prostate cancer
GLCE	Ehlers-Danlos syndrome progeroid type
MAGI3	prostate cancer
PYDC1	IgA glomerulonephritis
LRRTM2	autistic disorder
LTN1	IgA glomerulonephritis
ZNF500	breast cancer
DNM3	IgA glomerulonephritis
ERC2	prostate cancer
APPL1	prostate cancer
HACL1	Sjogren-Larsson syndrome
DECR2	prostate cancer
RAI14	IgA glomerulonephritis
ARHGEF26	IgA glomerulonephritis
KLK13	prostate cancer
GGA1	IgA glomerulonephritis
ABHD12	IgA glomerulonephritis
HERC4	IgA glomerulonephritis
CHTOP	human immunodeficiency virus infectious disease
WIPI2	IgA glomerulonephritis
PYGO1	breast cancer
WSB1	IgA glomerulonephritis
LDLRAP1	IgA glomerulonephritis
GAPVD1	IgA glomerulonephritis
TRPC4AP	IgA glomerulonephritis
IRF2BP1	IgA glomerulonephritis
TRAF3IP1	Bardet-Biedl syndrome
ZNF658	breast cancer
NAT9	prostate cancer
ZNF337	breast cancer
KIF26A	IgA glomerulonephritis
NOC2L	breast cancer
RSL1D1	IgA glomerulonephritis
GIMAP2	IgA glomerulonephritis
GARS	prostate cancer
STEAP2	IgA glomerulonephritis
INTS1	IgA glomerulonephritis
NPHP4	breast cancer
OR1F2P	IgA glomerulonephritis
OR1C1	endometriosis
OR1A2	endometriosis
FBXW2	IgA glomerulonephritis
AMD1	prostate cancer
OR2F1	IgA glomerulonephritis
OR2B6	IgA glomerulonephritis
OR1J4	endometriosis
FBXL21	IgA glomerulonephritis
FBXL3	IgA glomerulonephritis
B3GAT3	Ehlers-Danlos syndrome progeroid type
FBXO2	IgA glomerulonephritis
FBXL5	IgA glomerulonephritis
LCE2B	prostate cancer
OR2M4	IgA glomerulonephritis
OR2L2	endometriosis
OR2K2	endometriosis
KCNG2	autistic disorder
OPTC	prostate cancer
PTTG3P	IgA glomerulonephritis
BLOC1S6	IgA glomerulonephritis
FBXO25	IgA glomerulonephritis
FBXO22	IgA glomerulonephritis
SLC13A4	IgA glomerulonephritis
FBXO10	IgA glomerulonephritis
FBXO9	IgA glomerulonephritis
FBXO8	prostate cancer
FBXO5	IgA glomerulonephritis
FBXO4	IgA glomerulonephritis
HIBCH	maple syrup urine disease
PLA2G2D	IgA glomerulonephritis
FGF20	breast cancer
ERAL1	breast cancer
ARFGAP3	IgA glomerulonephritis
AK5	IgA glomerulonephritis
GALNT8	IgA glomerulonephritis
GBGT1	IgA glomerulonephritis
OR7A17	IgA glomerulonephritis
OR5L2	endometriosis
OR5K1	endometriosis
OR5H1	endometriosis
GBP3	IgA glomerulonephritis
GNL3	dyskeratosis congenita
GBX2	breast cancer
GCDH	obesity
GCHFR	phenylketonuria
PTPN18	IgA glomerulonephritis
BLOC1S1	IgA glomerulonephritis
OR10J1	endometriosis
KAT2A	breast cancer
NR6A1	breast cancer
OR8G2	IgA glomerulonephritis
OR8B8	endometriosis
OR8G1	IgA glomerulonephritis
OR9A1P	IgA glomerulonephritis
OR10A3	endometriosis
OR10D3	IgA glomerulonephritis
MYOF	prostate cancer
GCNT2	IgA glomerulonephritis
INTS6	IgA glomerulonephritis
TIMM10B	IgA glomerulonephritis
TIMM13	IgA glomerulonephritis
TIMM9	IgA glomerulonephritis
TIMM8B	IgA glomerulonephritis
AGO1	IgA glomerulonephritis
DAZAP1	stomach cancer
OR12D2	IgA glomerulonephritis
OR11A1	endometriosis
OR10H3	endometriosis
OR10G3	endometriosis
OR10G2	endometriosis
OR10H2	endometriosis
OR10H1	endometriosis
AATF	IgA glomerulonephritis
PCOLCE2	IgA glomerulonephritis
OSTF1	IgA glomerulonephritis
MRPL46	breast cancer
OR8B2	endometriosis
GDI1	IgA glomerulonephritis
OR7E24	IgA glomerulonephritis
OR7C2	endometriosis
OR7A5	endometriosis
OR7C1	endometriosis
BEST4	hypertension
MDGA1	IgA glomerulonephritis
RGL4	autistic disorder
OR4F4	endometriosis
OR4F3	endometriosis
OR4E2	endometriosis
OR4E1	IgA glomerulonephritis
OR4D1	endometriosis
OR2W1	endometriosis
OR2V1	endometriosis
OR2T1	endometriosis
ATP5L2	IgA glomerulonephritis
OR2J2	endometriosis
GFER	IgA glomerulonephritis
OR2H1	IgA glomerulonephritis
OR1L3	endometriosis
OR1L1	endometriosis
GFRA1	IgA glomerulonephritis
OR1J2	endometriosis
GFRA2	IgA glomerulonephritis
GFRA3	IgA glomerulonephritis
GGT3P	prostate cancer
B4GALT1	IgA glomerulonephritis
GGT7	prostate cancer
GGT5	prostate cancer
STEAP1	prostate cancer
OPLAH	prostate cancer
GHRHR	IgA glomerulonephritis
GIF	prostate cancer
GIP	obesity
COPG2	IgA glomerulonephritis
HBP1	breast cancer
CHORDC1	IgA glomerulonephritis
ZNF285	breast cancer
SEC22A	IgA glomerulonephritis
AP3M1	IgA glomerulonephritis
AKAP8L	IgA glomerulonephritis
RNF11	IgA glomerulonephritis
CYFIP2	IgA glomerulonephritis
ABL2	IgA glomerulonephritis
GJA3	hypertension
DNAJC2	IgA glomerulonephritis
USP21	IgA glomerulonephritis
FGF22	breast cancer
TPK1	prostate cancer
KCNV1	autistic disorder
BEX3	IgA glomerulonephritis
FOXD3	breast cancer
FOXB1	autistic disorder
GJA8	hypertension
NPHP3	Bardet-Biedl syndrome
ZBTB32	IgA glomerulonephritis
SIGLEC7	IgA glomerulonephritis
DIEXF	dyskeratosis congenita
PELP1	prostate cancer
NSG1	IgA glomerulonephritis
PPA2	IgA glomerulonephritis
DAPP1	IgA glomerulonephritis
LYPD3	IgA glomerulonephritis
B9D1	Bardet-Biedl syndrome
B3GAT1	Ehlers-Danlos syndrome progeroid type
UQCRQ	mitochondrial complex I deficiency
ST6GALNAC4	IgA glomerulonephritis
CACNG5	IgA glomerulonephritis
CACNG4	autistic disorder
KCNMB3	breast cancer
TRAPPC3	IgA glomerulonephritis
TAF5L	breast cancer
AMPD2	IgA glomerulonephritis
CACYBP	breast cancer
EIF2AK1	prostate cancer
ATP5S	mitochondrial complex I deficiency
GK2	coronary artery disease
DKK4	breast cancer
DKK3	breast cancer
DKK2	breast cancer
INPP5J	IgA glomerulonephritis
CYTH4	IgA glomerulonephritis
HSPB7	breast cancer
INVS	breast cancer
CPNE7	IgA glomerulonephritis
KCNH5	autistic disorder
DENND2A	IgA glomerulonephritis
ZNF777	breast cancer
BRPF3	IgA glomerulonephritis
NDOR1	prostate cancer
CHIA	IgA glomerulonephritis
NAAA	autistic disorder
GLS2	prostate cancer
PRELID1	breast cancer
TUBG2	IgA glomerulonephritis
IL36B	IgA glomerulonephritis
IL37	IgA glomerulonephritis
IL36A	IgA glomerulonephritis
SIGLEC9	IgA glomerulonephritis
SIGLEC8	IgA glomerulonephritis
VPS4A	IgA glomerulonephritis
IL17C	IgA glomerulonephritis
IL17B	prostate cancer
HCAR1	IgA glomerulonephritis
OXGR1	IgA glomerulonephritis
AMPD3	IgA glomerulonephritis
C5AR2	IgA glomerulonephritis
TUBGCP4	IgA glomerulonephritis
SERP1	prostate cancer
NMRK2	obesity
SULT1C4	prostate cancer
ARFIP1	IgA glomerulonephritis
ARHGEF16	IgA glomerulonephritis
GPKOW	human immunodeficiency virus infectious disease
GPR162	IgA glomerulonephritis
SIT1	IgA glomerulonephritis
CHMP2A	IgA glomerulonephritis
SESN1	breast cancer
AHDC1	breast cancer
ERLEC1	IgA glomerulonephritis
MMADHC	prostate cancer
PDCD4	IgA glomerulonephritis
KLHL20	IgA glomerulonephritis
LSM3	human immunodeficiency virus infectious disease
SULT1B1	prostate cancer
SRPX2	prostate cancer
RBMXL2	human immunodeficiency virus infectious disease
RND1	prostate cancer
R3HCC1L	IgA glomerulonephritis
DIMT1	dyskeratosis congenita
PDLIM3	IgA glomerulonephritis
CRCP	Treacher Collins syndrome
AMPH	IgA glomerulonephritis
ZNF544	breast cancer
APEX2	IgA glomerulonephritis
BMP10	prostate cancer
MOCS3	xanthinuria
RAB30	IgA glomerulonephritis
RBMX	human immunodeficiency virus infectious disease
TNRC6A	IgA glomerulonephritis
ANGPTL3	prostate cancer
RPS6KA6	IgA glomerulonephritis
GOLIM4	IgA glomerulonephritis
P2RY10	IgA glomerulonephritis
EIF3K	Diamond-Blackfan anemia
UBE2S	IgA glomerulonephritis
GLG1	IgA glomerulonephritis
RRP7A	dyskeratosis congenita
RABGEF1	IgA glomerulonephritis
POLL	IgA glomerulonephritis
KCNMB4	breast cancer
MCAT	obesity
APOBEC3C	breast cancer
SGSM3	breast cancer
GLRA2	autistic disorder
GLRB	autistic disorder
MAT2B	prostate cancer
POLM	IgA glomerulonephritis
GLS	prostate cancer
GLRX	prostate cancer
GLUD2	prostate cancer
AMY1A	IgA glomerulonephritis
GML	IgA glomerulonephritis
GMPR	breast cancer
GNA15	IgA glomerulonephritis
AMY1B	IgA glomerulonephritis
GNAO1	IgA glomerulonephritis
GNAT1	retinitis pigmentosa
AMY1C	IgA glomerulonephritis
GNAZ	IgA glomerulonephritis
GNB2	IgA glomerulonephritis
GNG3	IgA glomerulonephritis
GNG4	IgA glomerulonephritis
AMY2A	IgA glomerulonephritis
GNG10	IgA glomerulonephritis
GNGT1	IgA glomerulonephritis
GNGT2	IgA glomerulonephritis
GNRH2	IgA glomerulonephritis
AMY2B	IgA glomerulonephritis
GOLGA1	IgA glomerulonephritis
GOLGA2	IgA glomerulonephritis
GOLGB1	IgA glomerulonephritis
GOT1	prostate cancer
GOT2	prostate cancer
SELENOH	prostate cancer
GP2	IgA glomerulonephritis
GP5	IgA glomerulonephritis
GPD1	IgA glomerulonephritis
GPLD1	IgA glomerulonephritis
PPP2R3B	IgA glomerulonephritis
SLCO4A1	prostate cancer
GPR1	autistic disorder
IFNL2	IgA glomerulonephritis
IFNL1	IgA glomerulonephritis
AQP11	obesity
GPR3	autistic disorder
OR51B5	endometriosis
OR10AG1	endometriosis
OR5J2	endometriosis
GPR4	IgA glomerulonephritis
ZNF311	breast cancer
XCR1	IgA glomerulonephritis
FUOM	IgA glomerulonephritis
IGKV1-5	IgA glomerulonephritis
GPR6	autistic disorder
OR4C12	endometriosis
NPBWR1	IgA glomerulonephritis
OR52Z1	IgA glomerulonephritis
OR51V1	endometriosis
BCL9L	breast cancer
OR8D1	endometriosis
OR8D2	IgA glomerulonephritis
OR8B4	IgA glomerulonephritis
OR9G4	endometriosis
NPBWR2	IgA glomerulonephritis
P4HA3	amino acid metabolic disorder
PGM2L1	coronary artery disease
OR10A4	endometriosis
ZNF740	breast cancer
OR6C6	endometriosis
SLC39A5	IgA glomerulonephritis
SPRYD4	IgA glomerulonephritis
ADGRD1	IgA glomerulonephritis
PRLHR	IgA glomerulonephritis
KSR2	IgA glomerulonephritis
NME2P1	IgA glomerulonephritis
GATC	IgA glomerulonephritis
GXYLT1	IgA glomerulonephritis
GPR12	autistic disorder
OR4K3	IgA glomerulonephritis
SLC24A5	IgA glomerulonephritis
PRTG	breast cancer
OR4N4	endometriosis
UTS2R	IgA glomerulonephritis
PLA2G4D	IgA glomerulonephritis
FBXL22	IgA glomerulonephritis
CES4A	prostate cancer
NPW	IgA glomerulonephritis
PGP	glycine encephalopathy
INO80E	IgA glomerulonephritis
FADS6	liver cancer
ANGPT1	IgA glomerulonephritis
HEXDC	IgA glomerulonephritis
PIGW	breast cancer
GPR18	IgA glomerulonephritis
PTRF	prostate cancer
SLC26A11	IgA glomerulonephritis
GDPD1	IgA glomerulonephritis
KCTD1	breast cancer
SIGLEC15	IgA glomerulonephritis
GPR20	IgA glomerulonephritis
ZNF547	breast cancer
ZIK1	breast cancer
ZNF776	breast cancer
LYPD5	IgA glomerulonephritis
TPRX1	prostate cancer
IZUMO1	pneumoconiosis
ZNF615	breast cancer
OR2Z1	endometriosis
GPR21	IgA glomerulonephritis
IGHV3-23	IgA glomerulonephritis
OR10H5	endometriosis
ZNF493	breast cancer
HKR1	breast cancer
THEM5	prostate cancer
GPR22	autistic disorder
OR2L13	endometriosis
SLC9C2	hypertension
OR14A16	endometriosis
CYP4A22	prostate cancer
IGHV2-5	IgA glomerulonephritis
LPAR4	IgA glomerulonephritis
EPHA10	IgA glomerulonephritis
MCHR1	breast cancer
RIMKLA	autistic disorder
GPR25	IgA glomerulonephritis
GPR27	IgA glomerulonephritis
RTP5	IgA glomerulonephritis
NKIRAS2	IgA glomerulonephritis
NKIRAS1	IgA glomerulonephritis
DNAJC5G	prostate cancer
UNC80	hypertension
RGPD4	human immunodeficiency virus infectious disease
EPHA6	IgA glomerulonephritis
HTR3E	autistic disorder
ZNF619	breast cancer
ZNF621	breast cancer
GPR31	IgA glomerulonephritis
SLC9C1	hypertension
ZNF660	breast cancer
DPH3	IgA glomerulonephritis
GPR32	IgA glomerulonephritis
CYP4V2	prostate cancer
CRIPAK	IgA glomerulonephritis
COX18	mitochondrial complex I deficiency
ARL10	IgA glomerulonephritis
KIF4B	IgA glomerulonephritis
OR2V2	endometriosis
ZNF454	breast cancer
GPR34	autistic disorder
TRBV12-3	IgA glomerulonephritis
TREML4	IgA glomerulonephritis
SPDYE1	IgA glomerulonephritis
ZNF775	breast cancer
ATG9B	IgA glomerulonephritis
NSMCE2	IgA glomerulonephritis
ZNF707	breast cancer
GPR37	IgA glomerulonephritis
SCARA5	IgA glomerulonephritis
FBXO43	IgA glomerulonephritis
MLNR	IgA glomerulonephritis
CRB2	breast cancer
SCAI	IgA glomerulonephritis
LCN12	IgA glomerulonephritis
OR13C9	endometriosis
OR13D1	endometriosis
TRBC1	IgA glomerulonephritis
FFAR1	IgA glomerulonephritis
ATP11C	autistic disorder
H2BFM	IgA glomerulonephritis
YIPF6	IgA glomerulonephritis
FFAR3	IgA glomerulonephritis
P2RY8	autistic disorder
GPR42	autistic disorder
FFAR2	IgA glomerulonephritis
GRK4	IgA glomerulonephritis
LIN9	IgA glomerulonephritis
TRIM59	prostate cancer
KRT6C	prostate cancer
MKNK2	IgA glomerulonephritis
GPS1	IgA glomerulonephritis
GPS2	breast cancer
TRAC	IgA glomerulonephritis
IGLV7-43	IgA glomerulonephritis
GPX5	prostate cancer
GPX7	prostate cancer
IGLV1-51	IgA glomerulonephritis
IGLC7	IgA glomerulonephritis
GRB2	IgA glomerulonephritis
IGKV3D-20	IgA glomerulonephritis
IGKV3D-11	IgA glomerulonephritis
RAPGEF1	IgA glomerulonephritis
IGKV1D-33	IgA glomerulonephritis
IGKV4-1	IgA glomerulonephritis
IGKV3-20	IgA glomerulonephritis
IGKV2-40	IgA glomerulonephritis
GRIA3	autistic disorder
GRID1	prostate cancer
GRID2	autistic disorder
LAMTOR2	IgA glomerulonephritis
GRN	IgA glomerulonephritis
DCPS	stomach cancer
OSTM1	hypertension
GIT1	IgA glomerulonephritis
SLC27A6	IgA glomerulonephritis
SLC6A16	prostate cancer
SPCS1	obesity
ACAD9	mitochondrial complex I deficiency
MRPL42	breast cancer
IFT81	Bardet-Biedl syndrome
FLVCR1	IgA glomerulonephritis
MAGEH1	prostate cancer
NOB1	dyskeratosis congenita
DBNL	IgA glomerulonephritis
HIPK2	breast cancer
GRIK4	autistic disorder
GRIK5	autistic disorder
GRIN1	hypertension
GRIN2C	IgA glomerulonephritis
GRIN2D	IgA glomerulonephritis
C1GALT1C1	IgA glomerulonephritis
MRPL18	breast cancer
CHMP4A	IgA glomerulonephritis
PHPT1	glaucoma
MRPL15	breast cancer
ARHGAP35	IgA glomerulonephritis
TIMM21	IgA glomerulonephritis
MRPL22	breast cancer
ORMDL2	IgA glomerulonephritis
RANGRF	type 2 diabetes mellitus
COMMD9	IgA glomerulonephritis
SLC25A4	IgA glomerulonephritis
SSU72	stomach cancer
SCG3	IgA glomerulonephritis
NXT1	human immunodeficiency virus infectious disease
SAP30BP	breast cancer
BRD7	breast cancer
GRM6	autistic disorder
SLC25A5	IgA glomerulonephritis
SLC25A6	IgA glomerulonephritis
GSPT1	Diamond-Blackfan anemia
GSTA2	prostate cancer
GSTA3	prostate cancer
GTF2A1	peripheral nervous system disease
GTF2A2	peripheral nervous system disease
GTF2B	peripheral nervous system disease
GTF2E1	peripheral nervous system disease
GTF2E2	peripheral nervous system disease
GTF2F1	peripheral nervous system disease
GTF2F2	peripheral nervous system disease
GTF2H2	peripheral nervous system disease
GTF2H3	peripheral nervous system disease
GTF2H4	peripheral nervous system disease
BRF1	Treacher Collins syndrome
GTF3C1	Treacher Collins syndrome
GTF3C2	Treacher Collins syndrome
BLNK	IgA glomerulonephritis
USP25	IgA glomerulonephritis
PACSIN3	IgA glomerulonephritis
TMOD4	prostate cancer
TMOD3	prostate cancer
TMOD2	prostate cancer
CARD10	IgA glomerulonephritis
GUCA1A	retinitis pigmentosa
NCAPH2	IgA glomerulonephritis
OLA1	IgA glomerulonephritis
UQCR10	mitochondrial complex I deficiency
GUCA2A	prostate cancer
ZDHHC8	prostate cancer
VPREB3	IgA glomerulonephritis
GUCY1B3	breast cancer
GUCY2C	IgA glomerulonephritis
SENP1	IgA glomerulonephritis
TFPT	IgA glomerulonephritis
TRPM5	autistic disorder
UBN1	breast cancer
GUCY2F	retinitis pigmentosa
GUK1	IgA glomerulonephritis
ALG5	IgA glomerulonephritis
NPC1L1	prostate cancer
ANAPC2	IgA glomerulonephritis
CNOT7	stomach cancer
GNL2	dyskeratosis congenita
MYLPF	prostate cancer
EEF2K	breast cancer
ST8SIA5	IgA glomerulonephritis
SNX15	IgA glomerulonephritis
GPR171	autistic disorder
HCFC2	IgA glomerulonephritis
PYCR2	amino acid metabolic disorder
HILPDA	prostate cancer
EPN1	IgA glomerulonephritis
GMPPB	IgA glomerulonephritis
GMPPA	IgA glomerulonephritis
SEC61A1	IgA glomerulonephritis
TIMM22	IgA glomerulonephritis
GPR132	IgA glomerulonephritis
SNX12	IgA glomerulonephritis
RPA4	IgA glomerulonephritis
GYPB	IgA glomerulonephritis
DSE	Ehlers-Danlos syndrome progeroid type
PKN3	IgA glomerulonephritis
PADI1	rheumatoid arthritis
ANAPC4	IgA glomerulonephritis
DNMT3L	breast cancer
DPP7	IgA glomerulonephritis
POMT2	IgA glomerulonephritis
CERS2	IgA glomerulonephritis
DMGDH	prostate cancer
NRBP1	breast cancer
MRM2	stomach cancer
LRP12	prostate cancer
MDFIC	breast cancer
GYS1	IgA glomerulonephritis
SCHIP1	breast cancer
A1CF	breast cancer
UBQLN1	IgA glomerulonephritis
GYS2	IgA glomerulonephritis
NRBF2	breast cancer
RHOD	IgA glomerulonephritis
SLC39A3	IgA glomerulonephritis
SLC39A2	IgA glomerulonephritis
SLC2A8	IgA glomerulonephritis
PILRA	IgA glomerulonephritis
PACSIN1	IgA glomerulonephritis
ACAA1	prostate cancer
GZMA	IgA glomerulonephritis
TLX3	breast cancer
GZMM	IgA glomerulonephritis
HIST1H1D	breast cancer
HIST1H1B	breast cancer
HIST1H2AE	IgA glomerulonephritis
HIST1H2AD	IgA glomerulonephritis
HIST1H2BD	IgA glomerulonephritis
HIST1H2BB	IgA glomerulonephritis
HIST1H1A	breast cancer
HAGH	obesity
HAL	prostate cancer
HCCS	prostate cancer
HCK	IgA glomerulonephritis
HCRTR1	IgA glomerulonephritis
CFHR2	IgA glomerulonephritis
PLA2G2E	IgA glomerulonephritis
ST6GALNAC6	IgA glomerulonephritis
ADGRE2	IgA glomerulonephritis
KCNIP3	breast cancer
KCNIP2	hypertension
KCNIP1	Parkinson's disease
CXXC1	prostate cancer
HGFAC	prostate cancer
ZNF354C	breast cancer
NT5C	IgA glomerulonephritis
SOCS7	IgA glomerulonephritis
EHD4	IgA glomerulonephritis
EHD2	IgA glomerulonephritis
PIK3R4	IgA glomerulonephritis
TAX1BP3	IgA glomerulonephritis
UBE2K	IgA glomerulonephritis
HLA-DMB	IgA glomerulonephritis
MNX1	type 2 diabetes mellitus
HLA-DOA	IgA glomerulonephritis
HLA-DOB	IgA glomerulonephritis
HLA-DRB3	IgA glomerulonephritis
HLA-H	IgA glomerulonephritis
AOC2	prostate cancer
HLX	IgA glomerulonephritis
HMGN2	IgA glomerulonephritis
HMGCL	maple syrup urine disease
HMGCS1	porokeratosis
HMOX2	prostate cancer
HNF4G	breast cancer
ONECUT1	breast cancer
EIF4E3	IgA glomerulonephritis
SLC29A2	IgA glomerulonephritis
DHRS4L2	prostate cancer
HIST2H2AB	IgA glomerulonephritis
HNRNPAB	human immunodeficiency virus infectious disease
HNRNPC	human immunodeficiency virus infectious disease
HNRNPD	human immunodeficiency virus infectious disease
HNRNPF	breast cancer
HNRNPH2	human immunodeficiency virus infectious disease
HNRNPH3	IgA glomerulonephritis
APOF	prostate cancer
TAAR6	IgA glomerulonephritis
HNRNPU	human immunodeficiency virus infectious disease
TLX2	breast cancer
APBA1	autistic disorder
HOXA7	IgA glomerulonephritis
APBA2	autistic disorder
HOXB1	hypospadias
HOXB2	hypospadias
HOXB4	hypospadias
HOXB9	mouth disease
APBB1	breast cancer
HOXC8	prostate cancer
HOXC9	breast cancer
HOXC11	breast cancer
HOXD4	hypospadias
HOXD8	IgA glomerulonephritis
HPR	IgA glomerulonephritis
HPS1	IgA glomerulonephritis
ZAR1	prostate cancer
ERAS	breast cancer
AGFG1	IgA glomerulonephritis
PRMT2	IgA glomerulonephritis
PRMT1	breast cancer
HSBP1	prostate cancer
HSF1	IgA glomerulonephritis
HSF2	prostate cancer
ACADL	obesity
HSPA1L	IgA glomerulonephritis
HSPA6	IgA glomerulonephritis
HSPA7	IgA glomerulonephritis
HSPB2	IgA glomerulonephritis
DNAJB1	IgA glomerulonephritis
PPM1J	breast cancer
HIST2H3A	IgA glomerulonephritis
NDST1	Ehlers-Danlos syndrome progeroid type
HTN3	IgA glomerulonephritis
HTR1E	autistic disorder
HTR1F	autistic disorder
HTR6	autistic disorder
HYAL1	IgA glomerulonephritis
IARS	IgA glomerulonephritis
CHSY3	Ehlers-Danlos syndrome progeroid type
KRTAP8-1	prostate cancer
IBSP	prostate cancer
NLRP10	IgA glomerulonephritis
IFNE	IgA glomerulonephritis
ANO9	hypertension
FFAR4	IgA glomerulonephritis
ST8SIA6	IgA glomerulonephritis
ICAM4	IgA glomerulonephritis
OR8D4	endometriosis
OR5F1	endometriosis
OR5AP2	endometriosis
OR52L1	endometriosis
OR2AG2	endometriosis
KRT79	prostate cancer
SLCO1B7	prostate cancer
APOBEC1	breast cancer
RAB43	IgA glomerulonephritis
ENPP7	IgA glomerulonephritis
MSL1	breast cancer
CPLX4	autistic disorder
ZNF546	breast cancer
ADAMTSL5	IgA glomerulonephritis
RXFP4	prostate cancer
ZBTB8OS	stomach cancer
TFAP2E	breast cancer
ZNF678	breast cancer
ZFP69	breast cancer
MRPL58	breast cancer
SPOPL	IgA glomerulonephritis
CYP27C1	prostate cancer
NAT8L	prostate cancer
ARSI	IgA glomerulonephritis
MYLK4	IgA glomerulonephritis
TREML1	IgA glomerulonephritis
ZNF680	breast cancer
COL28A1	IgA glomerulonephritis
ZNF517	breast cancer
RSPO2	breast cancer
ZDHHC21	IgA glomerulonephritis
ACER2	IgA glomerulonephritis
PABPC1L2A	stomach cancer
LIPM	prostate cancer
CYP26C1	prostate cancer
OR52B6	endometriosis
OR2AT4	endometriosis
HEPHL1	glycoproteinosis
OR10A2	IgA glomerulonephritis
SYT10	autistic disorder
ACSM4	lung benign neoplasm
OR6C2	endometriosis
OR6C4	endometriosis
OR6S1	endometriosis
IDH3A	obesity
COX8C	mitochondrial complex I deficiency
IDI1	porokeratosis
PKD1L3	autistic disorder
CD300E	IgA glomerulonephritis
KRT27	prostate cancer
LEUTX	prostate cancer
ZNF404	IgA glomerulonephritis
ZNF677	breast cancer
AQP8	IgA glomerulonephritis
OR6F1	endometriosis
OR2W3	endometriosis
OR2T8	endometriosis
OR2T3	endometriosis
OR10R2	endometriosis
OR2T29	endometriosis
ARHGAP40	IgA glomerulonephritis
RSPO4	breast cancer
FIGLA	prostate cancer
IFNA4	IgA glomerulonephritis
FOXI3	breast cancer
IFNA6	IgA glomerulonephritis
IFNA7	IgA glomerulonephritis
IFNA8	IgA glomerulonephritis
IFNA10	IgA glomerulonephritis
IFNA13	IgA glomerulonephritis
ZNF860	breast cancer
IFNA14	IgA glomerulonephritis
RTP2	IgA glomerulonephritis
IFNA16	IgA glomerulonephritis
ATP13A5	autistic disorder
LOC344967	obesity
IFNA17	IgA glomerulonephritis
IFNA21	IgA glomerulonephritis
SLC10A6	IgA glomerulonephritis
HSD17B13	prostate cancer
PFN3	IgA glomerulonephritis
PLCXD3	breast cancer
APOC4	prostate cancer
OR6V1	endometriosis
OR2A12	endometriosis
OR2A1	endometriosis
MOGAT3	IgA glomerulonephritis
IFNW1	IgA glomerulonephritis
QRFP	IgA glomerulonephritis
OR1J1	endometriosis
OR1B1	IgA glomerulonephritis
KIF24	Bardet-Biedl syndrome
OR13H1	endometriosis
IFRD1	IgA glomerulonephritis
DGAT2L6	IgA glomerulonephritis
RAB41	IgA glomerulonephritis
ARSH	IgA glomerulonephritis
TUBB8	IgA glomerulonephritis
LRRTM1	autistic disorder
LRRTM3	autistic disorder
CATSPER3	pneumoconiosis
TUBB2B	IgA glomerulonephritis
SLC35B2	prostate cancer
SERINC2	prostate cancer
AMIGO2	IgA glomerulonephritis
ACSM2B	lung benign neoplasm
CTU2	stomach cancer
SKA2	IgA glomerulonephritis
IGFALS	prostate cancer
SELENOV	prostate cancer
ZNF530	breast cancer
GEN1	breast cancer
IGFBP4	prostate cancer
NUP43	IgA glomerulonephritis
ZNF713	breast cancer
IGHA1	IgA glomerulonephritis
IGHA2	IgA glomerulonephritis
IGHD	IgA glomerulonephritis
PLET1	IgA glomerulonephritis
RTN4RL2	IgA glomerulonephritis
IGHE	IgA glomerulonephritis
ACADS	obesity
APOH	IgA glomerulonephritis
IGHG1	IgA glomerulonephritis
IGHG2	IgA glomerulonephritis
IGHG3	IgA glomerulonephritis
IGHG4	IgA glomerulonephritis
IGHM	IgA glomerulonephritis
JCHAIN	IgA glomerulonephritis
IGKC	IgA glomerulonephritis
ZNF429	breast cancer
RAET1G	IgA glomerulonephritis
LCE1A	prostate cancer
LCE1B	prostate cancer
LCE1C	prostate cancer
LCE1D	prostate cancer
LCE1E	prostate cancer
LCE1F	prostate cancer
LCE2A	prostate cancer
LCE2C	prostate cancer
LCE2D	prostate cancer
LCE3A	prostate cancer
LCE3E	prostate cancer
TAS2R42	autistic disorder
SLCO4C1	IgA glomerulonephritis
ZNF445	breast cancer
KRT26	prostate cancer
RGSL1	IgA glomerulonephritis
KRTAP12-2	prostate cancer
ZNF233	breast cancer
TICAM2	IgA glomerulonephritis
POLN	IgA glomerulonephritis
BMP8A	IgA glomerulonephritis
LILRA5	IgA glomerulonephritis
IGLC1	human immunodeficiency virus infectious disease
IGLC2	IgA glomerulonephritis
IGLC3	IgA glomerulonephritis
IGLC6	IgA glomerulonephritis
IKBKB	IgA glomerulonephritis
IL3RA	IgA glomerulonephritis
IL13RA2	IgA glomerulonephritis
NANOGNB	prostate cancer
IL15RA	IgA glomerulonephritis
PRSS41	IgA glomerulonephritis
FOXK2	IgA glomerulonephritis
IMPDH2	IgA glomerulonephritis
ING2	breast cancer
INHA	breast cancer
INHBB	breast cancer
INHBC	breast cancer
AQP6	obesity
INPP4A	IgA glomerulonephritis
INPP5A	IgA glomerulonephritis
INPP5B	IgA glomerulonephritis
INPPL1	IgA glomerulonephritis
INSIG1	prostate cancer
EIF3E	Diamond-Blackfan anemia
IRAK2	IgA glomerulonephritis
IRF2	IgA glomerulonephritis
IRF3	IgA glomerulonephritis
ISLR	IgA glomerulonephritis
ITGA1	IgA glomerulonephritis
ITGA3	IgA glomerulonephritis
ITGAD	IgA glomerulonephritis
ITGAE	IgA glomerulonephritis
ITGB7	IgA glomerulonephritis
ITIH3	IgA glomerulonephritis
ACADVL	obesity
ITIH4	IgA glomerulonephritis
STT3A	IgA glomerulonephritis
ITPK1	IgA glomerulonephritis
ITPKA	IgA glomerulonephritis
ITPKB	IgA glomerulonephritis
ITPR2	IgA glomerulonephritis
JAK1	IgA glomerulonephritis
ARCN1	IgA glomerulonephritis
JARID2	breast cancer
KARS	IgA glomerulonephritis
KCNA1	autistic disorder
KCNA3	autistic disorder
DND1	prostate cancer
KCNA4	autistic disorder
KCNA6	IgA glomerulonephritis
KCNA7	autistic disorder
NHLRC2	IgA glomerulonephritis
GALNT18	IgA glomerulonephritis
NCR3LG1	IgA glomerulonephritis
TMEM179B	IgA glomerulonephritis
KCNA10	autistic disorder
TBC1D10C	IgA glomerulonephritis
KRT77	prostate cancer
ZNF710	breast cancer
HDDC3	IgA glomerulonephritis
KCNC2	autistic disorder
KCNC3	autistic disorder
ATP9B	autistic disorder
ZNF699	breast cancer
ZNF568	breast cancer
B3GNT8	IgA glomerulonephritis
ZNF773	breast cancer
ARF1	IgA glomerulonephritis
KCND1	autistic disorder
SFT2D2	IgA glomerulonephritis
KCND2	hypertension
PFN4	IgA glomerulonephritis
AQP12A	obesity
NRROS	IgA glomerulonephritis
KCNF1	autistic disorder
KCNG1	autistic disorder
PNPLA7	IgA glomerulonephritis
CYSRT1	IgA glomerulonephritis
KCNJ3	hypertension
RAB15	IgA glomerulonephritis
SLC27A1	prostate cancer
KCNJ9	autistic disorder
KCNJ12	autistic disorder
ARF3	IgA glomerulonephritis
KCNJ14	type 2 diabetes mellitus
KCNJ16	autistic disorder
KCNK1	hypertension
KCNK2	type 2 diabetes mellitus
USP17L2	IgA glomerulonephritis
CA13	obesity
KCNK3	type 2 diabetes mellitus
ENTPD8	breast cancer
ARF4	IgA glomerulonephritis
KCNN1	autistic disorder
KCNS1	autistic disorder
CENPS	IgA glomerulonephritis
KCNS2	autistic disorder
CATSPER4	pneumoconiosis
KCNS3	autistic disorder
KEL	IgA glomerulonephritis
KHK	IgA glomerulonephritis
KIF3C	IgA glomerulonephritis
KIFC3	IgA glomerulonephritis
KIR2DL1	IgA glomerulonephritis
KIR2DL2	IgA glomerulonephritis
KIR2DL3	IgA glomerulonephritis
KIR2DL4	IgA glomerulonephritis
KIR2DS1	IgA glomerulonephritis
KIR2DS3	IgA glomerulonephritis
KIR2DS4	IgA glomerulonephritis
ARF5	IgA glomerulonephritis
KIR2DS5	IgA glomerulonephritis
KIR3DL2	IgA glomerulonephritis
KIR3DS1	IgA glomerulonephritis
ARF6	IgA glomerulonephritis
KLRC1	IgA glomerulonephritis
KLRC3	IgA glomerulonephritis
KLRD1	IgA glomerulonephritis
KLC1	IgA glomerulonephritis
KIFC1	IgA glomerulonephritis
KIF25	IgA glomerulonephritis
KIF22	IgA glomerulonephritis
KPNA1	IgA glomerulonephritis
KPNA3	IgA glomerulonephritis
KPNA4	IgA glomerulonephritis
KPNA5	IgA glomerulonephritis
TNPO1	stomach cancer
IPO5	IgA glomerulonephritis
KRT9	prostate cancer
KRTAP10-4	prostate cancer
KRTAP10-7	prostate cancer
KRTAP10-9	prostate cancer
KRTAP10-2	prostate cancer
ZKSCAN4	breast cancer
SUMO4	human immunodeficiency virus infectious disease
C6orf120	IgA glomerulonephritis
KRTAP5-1	prostate cancer
KRTAP5-4	prostate cancer
TBPL2	IgA glomerulonephritis
NSUN4	stomach cancer
GPR153	prostate cancer
TMEM189	IgA glomerulonephritis
FAM21A	IgA glomerulonephritis
SLC16A12	IgA glomerulonephritis
OR56B1	endometriosis
SPDYC	IgA glomerulonephritis
LIPT2	prostate cancer
KMT5A	IgA glomerulonephritis
NHLRC3	IgA glomerulonephritis
IGHV1OR15-1	IgA glomerulonephritis
KRT31	prostate cancer
TNFAIP8L3	IgA glomerulonephritis
KRT33A	prostate cancer
SPDYE4	IgA glomerulonephritis
CCL4L1	IgA glomerulonephritis
KRT33B	prostate cancer
KRT34	prostate cancer
ZNF790	breast cancer
ZNF761	breast cancer
ZNF470	breast cancer
ZNF749	breast cancer
ZNF324B	breast cancer
KRT35	prostate cancer
GBP7	IgA glomerulonephritis
SLC6A17	prostate cancer
HRNR	IgA glomerulonephritis
FLG2	IgA glomerulonephritis
CAPN8	prostate cancer
COA6	IgA glomerulonephritis
OR14A2	IgA glomerulonephritis
KRT82	prostate cancer
KRT84	prostate cancer
SLC9A4	IgA glomerulonephritis
OR6B2	endometriosis
KRT85	prostate cancer
ZNF662	breast cancer
ARHGEF37	IgA glomerulonephritis
GLYATL3	lung benign neoplasm
IYD	prostate cancer
KTN1	IgA glomerulonephritis
LAMTOR4	breast cancer
MAFA	prostate cancer
LCN15	IgA glomerulonephritis
UBE2NL	IgA glomerulonephritis
ACAT2	porokeratosis
OR52K1	endometriosis
OR52I1	endometriosis
OR51D1	endometriosis
OR52A4P	IgA glomerulonephritis
OR52A5	endometriosis
OR51B6	endometriosis
OR51M1	endometriosis
OR51Q1	endometriosis
OR51I1	endometriosis
OR51I2	endometriosis
OR52D1	endometriosis
OR52H1	endometriosis
OR52N4	endometriosis
OR56B2P	IgA glomerulonephritis
OR52N5	endometriosis
OR52N2	endometriosis
OR52E6	endometriosis
OR52E8	endometriosis
OR52E4	endometriosis
OR52E5	IgA glomerulonephritis
OR56A3	endometriosis
OR56A5	IgA glomerulonephritis
OR10A6	IgA glomerulonephritis
OR4X1	endometriosis
OR4A4P	IgA glomerulonephritis
OR5D13	IgA glomerulonephritis
OR5D16	endometriosis
OR5W2	endometriosis
OR8H2	endometriosis
OR8H3	endometriosis
OR5T3	endometriosis
OR5T1	endometriosis
OR8K1	endometriosis
OR5M9	endometriosis
OR5M10	endometriosis
OR5M1	endometriosis
OR9G1	endometriosis
OR5AK2	endometriosis
OR5B2	endometriosis
OR5B12	endometriosis
OR5AN1	endometriosis
OR4D10	endometriosis
OR4D9	endometriosis
LAG3	IgA glomerulonephritis
OR10V1	endometriosis
IZUMO1R	IgA glomerulonephritis
OR6X1	endometriosis
OR6M1	endometriosis
OR10G4	endometriosis
OR10G7	endometriosis
OR10D4P	IgA glomerulonephritis
OR8B3	endometriosis
OR6C1	endometriosis
OR6C75	endometriosis
OR6C76	endometriosis
OR6C70	endometriosis
OR4N2	endometriosis
OR4K2	endometriosis
OR4Q2	IgA glomerulonephritis
OR4K13	endometriosis
OR4K17	endometriosis
OR4N5	endometriosis
OR11G2	endometriosis
OR11H7	IgA glomerulonephritis
OR11H4	endometriosis
OR5AU1	endometriosis
OR4M2	IgA glomerulonephritis
KBTBD13	IgA glomerulonephritis
LALBA	IgA glomerulonephritis
OR4F6	endometriosis
OR4F15	endometriosis
PABPN1L	IgA glomerulonephritis
KRT39	prostate cancer
OR7G2	endometriosis
OR7G3	endometriosis
OR7A10	endometriosis
OR7A2P	IgA glomerulonephritis
NUDT19	IgA glomerulonephritis
ZNF793	breast cancer
RHOG	IgA glomerulonephritis
LAMA4	prostate cancer
PLA2G2C	IgA glomerulonephritis
OR10K2	endometriosis
OR10K1	endometriosis
OR6Y1	endometriosis
OR6K3	endometriosis
OR10J4	IgA glomerulonephritis
OR11L1	endometriosis
OR2L8	IgA glomerulonephritis
OR2AK2	endometriosis
OR2L3	endometriosis
OR2M2	endometriosis
OR2T33	endometriosis
OR2M7	endometriosis
OR2G6	endometriosis
SULT6B1	prostate cancer
LAMP1	IgA glomerulonephritis
USP17L9P	IgA glomerulonephritis
ARHGAP1	IgA glomerulonephritis
RPSA	Diamond-Blackfan anemia
OR10AC1	IgA glomerulonephritis
OR2A25	endometriosis
USP17L8	IgA glomerulonephritis
OR13J1	endometriosis
OR13C2	IgA glomerulonephritis
OR1L6	endometriosis
OR5C1	endometriosis
OR1K1	endometriosis
LCN9	IgA glomerulonephritis
OR2A5	IgA glomerulonephritis
LCK	IgA glomerulonephritis
LCN1	IgA glomerulonephritis
LCP2	IgA glomerulonephritis
LCT	IgA glomerulonephritis
ARHGAP5	IgA glomerulonephritis
MUC21	IgA glomerulonephritis
ARHGAP6	IgA glomerulonephritis
LECT2	IgA glomerulonephritis
LFNG	IgA glomerulonephritis
LGALS3BP	IgA glomerulonephritis
LHX1	breast cancer
ARHGDIG	IgA glomerulonephritis
LIG3	IgA glomerulonephritis
LIMK2	IgA glomerulonephritis
LIMS1	prostate cancer
RHOH	IgA glomerulonephritis
LIPE	IgA glomerulonephritis
LLGL2	prostate cancer
SPRED3	IgA glomerulonephritis
FADS3	prostate cancer
MYO18A	IgA glomerulonephritis
SHC4	IgA glomerulonephritis
LMAN1	IgA glomerulonephritis
METTL10	IgA glomerulonephritis
ARL1	IgA glomerulonephritis
MED11	prostate cancer
SIGLEC16	IgA glomerulonephritis
ZNF772	breast cancer
DEFB132	IgA glomerulonephritis
LMX1A	prostate cancer
RGPD1	human immunodeficiency virus infectious disease
PHOX2A	prostate cancer
ASB18	IgA glomerulonephritis
LNPEP	IgA glomerulonephritis
RAB44	IgA glomerulonephritis
RAB19	IgA glomerulonephritis
OR2A7	endometriosis
USP17L1	IgA glomerulonephritis
HACD4	obesity
TOMM5	IgA glomerulonephritis
ZNF658B	breast cancer
CENPP	IgA glomerulonephritis
OR51H1	IgA glomerulonephritis
OR51T1	endometriosis
OR51A4	endometriosis
OR51A2	endometriosis
OR10J6P	IgA glomerulonephritis
OR2T2	endometriosis
OR2T5	endometriosis
OR14I1	endometriosis
OR5K2	endometriosis
OR2A42	endometriosis
LPO	IgA glomerulonephritis
KPNA7	IgA glomerulonephritis
ARL3	Bardet-Biedl syndrome
OR2T27	endometriosis
OR2T35	IgA glomerulonephritis
OR4A47	endometriosis
OR4C45	IgA glomerulonephritis
OR5H14	endometriosis
OR5H15	endometriosis
OR5K3	endometriosis
OR5K4	endometriosis
OR6C65	endometriosis
OR6C68	endometriosis
LRMP	IgA glomerulonephritis
APOBEC4	breast cancer
DEFB133	IgA glomerulonephritis
LRP6	breast cancer
SPINK6	prostate cancer
LRPAP1	IgA glomerulonephritis
LSAMP	IgA glomerulonephritis
LTB	IgA glomerulonephritis
CYP4F3	prostate cancer
LTBP1	prostate cancer
LTC4S	prostate cancer
DUOXA2	prostate cancer
LY6H	IgA glomerulonephritis
LY9	IgA glomerulonephritis
CD180	IgA glomerulonephritis
SH2D1A	IgA glomerulonephritis
LYZ	IgA glomerulonephritis
ARR3	IgA glomerulonephritis
ARRB1	IgA glomerulonephritis
SMAD1	breast cancer
ARRB2	IgA glomerulonephritis
SMAD5	breast cancer
SMAD6	breast cancer
MAGEA1	breast cancer
MAGEA11	prostate cancer
MAGOH	human immunodeficiency virus infectious disease
MAN2A2	IgA glomerulonephritis
MAN2C1	IgA glomerulonephritis
MAN2A1	IgA glomerulonephritis
MAP1B	IgA glomerulonephritis
MAP2	prostate cancer
MAP4	prostate cancer
ARSD	IgA glomerulonephritis
MARK3	IgA glomerulonephritis
TBC1D3B	IgA glomerulonephritis
ACBD7	prostate cancer
MAS1	hypertension
DEFB103A	IgA glomerulonephritis
IDNK	IgA glomerulonephritis
MATN1	prostate cancer
MATN3	prostate cancer
MAX	IgA glomerulonephritis
DENND6B	IgA glomerulonephritis
ARSE	IgA glomerulonephritis
MB	prostate cancer
STX19	IgA glomerulonephritis
MBD1	prostate cancer
ARSF	IgA glomerulonephritis
MC5R	IgA glomerulonephritis
MCF2	IgA glomerulonephritis
ART1	IgA glomerulonephritis
MCM3	Meier-Gorlin syndrome
MCM4	Meier-Gorlin syndrome
MCM5	Meier-Gorlin syndrome
MCM6	Meier-Gorlin syndrome
MCM7	Meier-Gorlin syndrome
ADAM11	autistic disorder
DNAJB9	prostate cancer
ART3	IgA glomerulonephritis
MDH2	obesity
ART4	IgA glomerulonephritis
MEF2A	IgA glomerulonephritis
MEP1B	IgA glomerulonephritis
MFAP1	prostate cancer
MFAP2	prostate cancer
MFAP3	prostate cancer
MFAP4	prostate cancer
MFNG	IgA glomerulonephritis
MGAT1	IgA glomerulonephritis
MGAT2	IgA glomerulonephritis
MGAT3	IgA glomerulonephritis
MIA2	IgA glomerulonephritis
MGST2	prostate cancer
MGST3	prostate cancer
MID1	IgA glomerulonephritis
MIP	obesity
MAP3K10	IgA glomerulonephritis
MLN	IgA glomerulonephritis
MLLT1	peripheral nervous system disease
MLLT3	peripheral nervous system disease
AFDN	prostate cancer
FOXO4	IgA glomerulonephritis
TRPM1	hypertension
RGS21	IgA glomerulonephritis
ASGR1	IgA glomerulonephritis
ATP5EP2	IgA glomerulonephritis
MMP15	prostate cancer
MMP16	prostate cancer
MMP19	prostate cancer
ASGR2	IgA glomerulonephritis
MNAT1	IgA glomerulonephritis
MOCS1	xanthinuria
MOCS2	xanthinuria
MOS	IgA glomerulonephritis
CD200	IgA glomerulonephritis
MPG	autistic disorder
MPI	IgA glomerulonephritis
MPST	prostate cancer
KLK14	prostate cancer
KLK12	prostate cancer
ASNA1	prostate cancer
IFIT1B	IgA glomerulonephritis
TMEM41B	IgA glomerulonephritis
CARD17	IgA glomerulonephritis
IQSEC3	IgA glomerulonephritis
ZNF705A	breast cancer
H3F3C	IgA glomerulonephritis
ALG11	IgA glomerulonephritis
OR11H12	endometriosis
PLIN5	obesity
ZNF506	breast cancer
ZNF724	breast cancer
PSG8	IgA glomerulonephritis
UQCRHL	mitochondrial complex I deficiency
BCL2L15	prostate cancer
HIST2H2BF	IgA glomerulonephritis
MAP1LC3C	IgA glomerulonephritis
POTEKP	IgA glomerulonephritis
MTHFD2L	prostate cancer
ZNF716	breast cancer
SPDYE3	IgA glomerulonephritis
AKR1B15	prostate cancer
OR4F21	endometriosis
GLRA4	autistic disorder
PGAM4	prostate cancer
OR5B3	endometriosis
OR9K2	endometriosis
OR4Q3	endometriosis
OR4M1	endometriosis
TARM1	IgA glomerulonephritis
OR10J3	endometriosis
BECN2	IgA glomerulonephritis
OR2W5	IgA glomerulonephritis
OR13G1	endometriosis
SULT1C3	prostate cancer
GALNTL6	IgA glomerulonephritis
OR1F12	IgA glomerulonephritis
OR2B3	endometriosis
OR2J1	IgA glomerulonephritis
OR2J3	endometriosis
OR14J1	endometriosis
OR10C1	endometriosis
OR2I1P	IgA glomerulonephritis
ZNF727	breast cancer
OR2A2	endometriosis
SPDYE5	IgA glomerulonephritis
CITED1	breast cancer
ASPH	IgA glomerulonephritis
MSI1	stomach cancer
LCE6A	prostate cancer
MT1B	prostate cancer
MT1E	prostate cancer
MT1F	prostate cancer
MT1H	prostate cancer
MT1M	prostate cancer
MT1X	prostate cancer
MTCP1	IgA glomerulonephritis
NUDT1	IgA glomerulonephritis
MTHFD1	prostate cancer
MTIF2	breast cancer
MTX1	IgA glomerulonephritis
MUC5AC	IgA glomerulonephritis
ASTN1	breast cancer
MYBPC1	prostate cancer
MYBL2	IgA glomerulonephritis
MYBPC2	prostate cancer
MYBPH	IgA glomerulonephritis
MYF5	breast cancer
MYH1	prostate cancer
MYH2	prostate cancer
MYH3	prostate cancer
MYH4	prostate cancer
MYH8	prostate cancer
MYL1	IgA glomerulonephritis
MYL5	prostate cancer
MYL6	IgA glomerulonephritis
MYO1C	IgA glomerulonephritis
MYO1E	IgA glomerulonephritis
MYO9A	IgA glomerulonephritis
MYO10	IgA glomerulonephritis
MYOG	breast cancer
PPP1R12A	IgA glomerulonephritis
MYT1	IgA glomerulonephritis
NACA	IgA glomerulonephritis
HNRNPM	breast cancer
NARS	IgA glomerulonephritis
CEACAM6	IgA glomerulonephritis
NBL1	IgA glomerulonephritis
NCAM1	IgA glomerulonephritis
NCBP1	human immunodeficiency virus infectious disease
NDUFA3	mitochondrial complex I deficiency
NDUFA4	mitochondrial complex I deficiency
NDUFA5	mitochondrial complex I deficiency
NDUFA6	mitochondrial complex I deficiency
NDUFA7	mitochondrial complex I deficiency
NDUFA8	mitochondrial complex I deficiency
NEB	prostate cancer
NDUFA9	mitochondrial complex I deficiency
NDUFA10	mitochondrial complex I deficiency
NDUFAB1	mitochondrial complex I deficiency
NDUFB1	mitochondrial complex I deficiency
NDUFB2	mitochondrial complex I deficiency
NDUFB4	mitochondrial complex I deficiency
NDUFB5	mitochondrial complex I deficiency
NDUFB6	mitochondrial complex I deficiency
NDUFB10	mitochondrial complex I deficiency
NDUFC1	mitochondrial complex I deficiency
NDUFC2	mitochondrial complex I deficiency
NDUFS5	mitochondrial complex I deficiency
NDUFV3	mitochondrial complex I deficiency
SEPT2	breast cancer
RPL10A	Diamond-Blackfan anemia
NEDD8	IgA glomerulonephritis
H2AFB2	IgA glomerulonephritis
H2AFB1	IgA glomerulonephritis
NEK3	IgA glomerulonephritis
NEO1	prostate cancer
NEU2	IgA glomerulonephritis
NEUROG1	breast cancer
NFATC1	IgA glomerulonephritis
NFATC3	IgA glomerulonephritis
NFATC4	IgA glomerulonephritis
NFE2	IgA glomerulonephritis
NFIL3	IgA glomerulonephritis
NFIX	Treacher Collins syndrome
ATP12A	IgA glomerulonephritis
NFKBIB	IgA glomerulonephritis
NFRKB	IgA glomerulonephritis
NFX1	prostate cancer
ACO1	obesity
ATP1A4	hypertension
NFYB	IgA glomerulonephritis
NFYC	IgA glomerulonephritis
SNU13	stomach cancer
NKX2-2	prostate cancer
NMB	IgA glomerulonephritis
ATP1B3	hypertension
NME3	IgA glomerulonephritis
NME4	IgA glomerulonephritis
NMT1	IgA glomerulonephritis
NNMT	prostate cancer
NOP2	stomach cancer
NONO	breast cancer
CNOT2	stomach cancer
CNOT3	stomach cancer
CNOT4	stomach cancer
NPAT	IgA glomerulonephritis
NPR2	IgA glomerulonephritis
NPY6R	IgA glomerulonephritis
NRF1	breast cancer
ACR	pneumoconiosis
ATP2B2	IgA glomerulonephritis
NTN3	prostate cancer
ROR1	breast cancer
ROR2	breast cancer
NTS	IgA glomerulonephritis
NTSR1	IgA glomerulonephritis
NVL	dyskeratosis congenita
GPR143	IgA glomerulonephritis
TRIM72	prostate cancer
EID3	IgA glomerulonephritis
GPX8	prostate cancer
PHOSPHO2	status epilepticus
RBMXL1	human immunodeficiency virus infectious disease
CHAC2	prostate cancer
TBC1D25	IgA glomerulonephritis
WEE2	IgA glomerulonephritis
OAZ1	IgA glomerulonephritis
OAZ2	prostate cancer
OCA2	prostate cancer
ATP4A	stomach cancer
ODF2	IgA glomerulonephritis
OMD	IgA glomerulonephritis
ATP4B	stomach cancer
OGDH	obesity
OGN	IgA glomerulonephritis
OMG	IgA glomerulonephritis
OPA1	IgA glomerulonephritis
OPHN1	IgA glomerulonephritis
OPRK1	prostate cancer
CLDN20	prostate cancer
OR1D2	endometriosis
OR1F1	IgA glomerulonephritis
OR2C1	endometriosis
OR3A1	IgA glomerulonephritis
OR3A2	endometriosis
ORC2	Meier-Gorlin syndrome
ACO2	obesity
ORC5	Meier-Gorlin syndrome
ORM1	IgA glomerulonephritis
ORM2	IgA glomerulonephritis
OSBP	prostate cancer
OTX1	breast cancer
OXA1L	polycystic kidney disease
P2RX3	IgA glomerulonephritis
P2RX5	IgA glomerulonephritis
P2RY1	IgA glomerulonephritis
P2RY2	IgA glomerulonephritis
P2RY4	autistic disorder
P2RY6	IgA glomerulonephritis
P4HA1	prostate cancer
SPRN	IgA glomerulonephritis
ARGFX	prostate cancer
DEFB107B	IgA glomerulonephritis
DEFB104B	IgA glomerulonephritis
DEFB108P1	IgA glomerulonephritis
DPRX	prostate cancer
DEFB106B	IgA glomerulonephritis
DEFB105B	IgA glomerulonephritis
OR8U8	IgA glomerulonephritis
OR8U9	IgA glomerulonephritis
OR9G9	IgA glomerulonephritis
PABPC3	stomach cancer
FURIN	IgA glomerulonephritis
PCSK6	prostate cancer
G0S2	prostate cancer
PLA2G3	IgA glomerulonephritis
MINK1	IgA glomerulonephritis
CD207	IgA glomerulonephritis
PAFAH1B2	IgA glomerulonephritis
PAFAH1B3	IgA glomerulonephritis
NOX3	IgA glomerulonephritis
COL5A3	IgA glomerulonephritis
PAFAH2	IgA glomerulonephritis
CHST11	IgA glomerulonephritis
ATP5B	IgA glomerulonephritis
GALNT9	IgA glomerulonephritis
ATP6V0A4	IgA glomerulonephritis
DEF6	IgA glomerulonephritis
CUZD1	breast cancer
GEMIN4	human immunodeficiency virus infectious disease
PAK3	IgA glomerulonephritis
CALY	IgA glomerulonephritis
ANO7	hypertension
PNPLA8	IgA glomerulonephritis
ARHGEF4	IgA glomerulonephritis
NEUROG3	breast cancer
REG3A	IgA glomerulonephritis
RDH8	prostate cancer
KCNK4	type 2 diabetes mellitus
MYEF2	IgA glomerulonephritis
AK3	IgA glomerulonephritis
NSDHL	porokeratosis
PDCL	IgA glomerulonephritis
TAS2R3	autistic disorder
TAS2R4	autistic disorder
TAS2R16	autistic disorder
TAS2R1	autistic disorder
TAS2R9	autistic disorder
TAS2R8	autistic disorder
TAS2R7	autistic disorder
TAS2R13	autistic disorder
TAS2R10	autistic disorder
TAS2R14	autistic disorder
DHH	IgA glomerulonephritis
F11R	prostate cancer
TRAT1	IgA glomerulonephritis
PARD6A	IgA glomerulonephritis
NTM	IgA glomerulonephritis
HEBP1	IgA glomerulonephritis
ATP5C1	mitochondrial complex I deficiency
PBX3	breast cancer
PCBD1	phenylketonuria
PCBP1	human immunodeficiency virus infectious disease
CDON	prostate cancer
PCBP2	human immunodeficiency virus infectious disease
SLC35B3	prostate cancer
MTERF3	Alzheimer's disease
TPRKB	stomach cancer
MED31	breast cancer
AMDHD2	IgA glomerulonephritis
ASCC1	IgA glomerulonephritis
DERL2	IgA glomerulonephritis
EXOSC3	stomach cancer
EXOSC1	stomach cancer
TMED7	IgA glomerulonephritis
CCDC53	IgA glomerulonephritis
MRPS16	breast cancer
MRPS18C	breast cancer
PAM16	IgA glomerulonephritis
VPS36	IgA glomerulonephritis
GLOD4	prostate cancer
CELA2B	IgA glomerulonephritis
SERPINA5	IgA glomerulonephritis
ZBTB7B	breast cancer
ST8SIA3	IgA glomerulonephritis
PRLH	IgA glomerulonephritis
LAP3	prostate cancer
ZNF691	breast cancer
PCK2	IgA glomerulonephritis
TXNDC12	prostate cancer
RPS27L	Diamond-Blackfan anemia
YARS2	IgA glomerulonephritis
NMD3	human immunodeficiency virus infectious disease
MRPL2	breast cancer
NOSIP	IgA glomerulonephritis
MEMO1	breast cancer
MRPL4	breast cancer
APIP	prostate cancer
CUTC	autistic disorder
FCF1	dyskeratosis congenita
SEPSECS	prostate cancer
TRNT1	stomach cancer
UTP18	dyskeratosis congenita
SCCPDH	IgA glomerulonephritis
IFT52	Bardet-Biedl syndrome
ABHD5	IgA glomerulonephritis
SH3GLB1	IgA glomerulonephritis
MECR	obesity
TFB1M	breast cancer
APH1A	breast cancer
RDH11	prostate cancer
KMT5B	breast cancer
TRAPPC12	IgA glomerulonephritis
MRPS2	breast cancer
UTP11	dyskeratosis congenita
SBDS	dyskeratosis congenita
RPL26L1	Diamond-Blackfan anemia
ZNF706	breast cancer
GOLGA7	IgA glomerulonephritis
NAA20	prostate cancer
ASB3	IgA glomerulonephritis
CEP83	Bardet-Biedl syndrome
COPS4	IgA glomerulonephritis
INSIG2	prostate cancer
CHCHD2	IgA glomerulonephritis
DYNC1LI1	IgA glomerulonephritis
A4GNT	IgA glomerulonephritis
ING4	breast cancer
CERCAM	IgA glomerulonephritis
HN1	prostate cancer
PCNT	IgA glomerulonephritis
VPS28	IgA glomerulonephritis
AADAT	obesity
HSD17B11	prostate cancer
HSD17B14	prostate cancer
NAGPA	IgA glomerulonephritis
HAO2	prostate cancer
PCOLCE	IgA glomerulonephritis
RSL24D1	breast cancer
CHMP1A	IgA glomerulonephritis
DDX47	dyskeratosis congenita
ACP6	IgA glomerulonephritis
GP6	IgA glomerulonephritis
CLDN18	prostate cancer
RAB9B	IgA glomerulonephritis
LUZP4	human immunodeficiency virus infectious disease
ZNF219	breast cancer
TCEB3B	peripheral nervous system disease
COPZ2	IgA glomerulonephritis
GLTP	IgA glomerulonephritis
PHF20	breast cancer
VRK3	IgA glomerulonephritis
CRIM1	IgA glomerulonephritis
COX16	mitochondrial complex I deficiency
SHISA5	IgA glomerulonephritis
PDZD11	IgA glomerulonephritis
RNF181	IgA glomerulonephritis
TBC1D7	IgA glomerulonephritis
MRPL51	breast cancer
MRPL30	breast cancer
MRPL27	breast cancer
CLEC1B	IgA glomerulonephritis
KLF3	breast cancer
ZNF571	breast cancer
COA4	IgA glomerulonephritis
RXFP3	IgA glomerulonephritis
GMIP	IgA glomerulonephritis
CD320	prostate cancer
ECSIT	IgA glomerulonephritis
SLC15A3	IgA glomerulonephritis
BPIFA1	IgA glomerulonephritis
NRN1	IgA glomerulonephritis
GCNT4	IgA glomerulonephritis
CYP39A1	prostate cancer
FAM13B	IgA glomerulonephritis
REEP2	IgA glomerulonephritis
SLC22A17	IgA glomerulonephritis
PLAC8	IgA glomerulonephritis
PHF21A	IgA glomerulonephritis
MRPL35	breast cancer
SPG21	IgA glomerulonephritis
AHSP	acute intermittent porphyria
SPTBN5	IgA glomerulonephritis
ZNF771	breast cancer
DACT1	breast cancer
PDCD2	IgA glomerulonephritis
CRNKL1	human immunodeficiency virus infectious disease
FZR1	IgA glomerulonephritis
TAOK3	IgA glomerulonephritis
KLRF1	IgA glomerulonephritis
KRT76	prostate cancer
PDE1A	IgA glomerulonephritis
MBTPS2	prostate cancer
CDC40	human immunodeficiency virus infectious disease
CHST15	Ehlers-Danlos syndrome progeroid type
PLA1A	IgA glomerulonephritis
UBR5	IgA glomerulonephritis
POP5	stomach cancer
POMP	human immunodeficiency virus infectious disease
MRPS17	breast cancer
UCHL5	IgA glomerulonephritis
ANGPT4	IgA glomerulonephritis
CSAD	prostate cancer
ATP6V1D	IgA glomerulonephritis
WNT16	breast cancer
ZNF589	breast cancer
EIF3L	Diamond-Blackfan anemia
TRPV2	IgA glomerulonephritis
TRAPPC4	IgA glomerulonephritis
ATP5E	mitochondrial complex I deficiency
BIN2	IgA glomerulonephritis
ACTL6B	breast cancer
AMOTL2	IgA glomerulonephritis
SNX9	IgA glomerulonephritis
PDE4C	IgA glomerulonephritis
ANAPC5	IgA glomerulonephritis
ANAPC7	IgA glomerulonephritis
PCYOX1	porokeratosis
REV1	IgA glomerulonephritis
RHCG	IgA glomerulonephritis
UBE2J1	IgA glomerulonephritis
NAT8B	prostate cancer
HSD17B7	porokeratosis
RTCB	stomach cancer
HACD3	prostate cancer
NELFCD	peripheral nervous system disease
TRIAP1	breast cancer
PDE7A	IgA glomerulonephritis
CWC15	human immunodeficiency virus infectious disease
TRMT112	stomach cancer
PDE8A	IgA glomerulonephritis
GTSE1	IgA glomerulonephritis
ETV7	breast cancer
NCKIPSD	IgA glomerulonephritis
PDE9A	IgA glomerulonephritis
LARS	IgA glomerulonephritis
ANAPC11	IgA glomerulonephritis
VTA1	IgA glomerulonephritis
SCLY	prostate cancer
VPS54	IgA glomerulonephritis
SIRT6	IgA glomerulonephritis
CINP	IgA glomerulonephritis
RAB14	IgA glomerulonephritis
ACKR4	IgA glomerulonephritis
PEX5L	Zellweger syndrome
RAB6B	IgA glomerulonephritis
MBIP	breast cancer
TDP2	IgA glomerulonephritis
GDE1	IgA glomerulonephritis
PCF11	human immunodeficiency virus infectious disease
MED15	breast cancer
PIAS4	IgA glomerulonephritis
SRRT	human immunodeficiency virus infectious disease
LSR	IgA glomerulonephritis
ATP5G1	mitochondrial complex I deficiency
LIPT1	prostate cancer
NOP58	stomach cancer
TRMT6	stomach cancer
ATP6V1H	IgA glomerulonephritis
PDHA2	obesity
DPH5	IgA glomerulonephritis
TAF9B	peripheral nervous system disease
UBE2D4	IgA glomerulonephritis
CCZ1	IgA glomerulonephritis
DYNC2LI1	Bardet-Biedl syndrome
PDK1	IgA glomerulonephritis
OTUD6B	IgA glomerulonephritis
C14orf166	stomach cancer
SF3B6	human immunodeficiency virus infectious disease
MRPL48	breast cancer
PPIL1	human immunodeficiency virus infectious disease
PDK3	obesity
MRPS33	breast cancer
CHMP3	IgA glomerulonephritis
CDK5RAP1	IgA glomerulonephritis
ZFR	prostate cancer
ASB1	IgA glomerulonephritis
ASB4	IgA glomerulonephritis
HSPB11	Bardet-Biedl syndrome
TPPP3	IgA glomerulonephritis
ASB2	IgA glomerulonephritis
OAZ3	prostate cancer
ENPP3	IgA glomerulonephritis
LSM7	human immunodeficiency virus infectious disease
LSM8	human immunodeficiency virus infectious disease
CPSF3	human immunodeficiency virus infectious disease
VPS29	prostate cancer
ATP5G2	mitochondrial complex I deficiency
CYB5R2	IgA glomerulonephritis
NLK	breast cancer
PADI3	rheumatoid arthritis
ACSL5	obesity
GPRC5B	autistic disorder
CYB5R1	IgA glomerulonephritis
UIMC1	IgA glomerulonephritis
DNAJB11	prostate cancer
WBP11	human immunodeficiency virus infectious disease
MSRB1	prostate cancer
RAPGEF6	breast cancer
CDK12	breast cancer
C9orf78	IgA glomerulonephritis
INPP5K	IgA glomerulonephritis
GNG13	IgA glomerulonephritis
STK26	IgA glomerulonephritis
ZAK	prostate cancer
KDM3B	breast cancer
ATP5G3	mitochondrial complex I deficiency
ASIC5	IgA glomerulonephritis
SIX4	breast cancer
COQ3	multiple system atrophy
CALML5	IgA glomerulonephritis
TUBA8	IgA glomerulonephritis
PHAX	human immunodeficiency virus infectious disease
GATB	IgA glomerulonephritis
PF4V1	IgA glomerulonephritis
PFAS	breast cancer
CFP	IgA glomerulonephritis
ACP1	prostate cancer
PFDN1	IgA glomerulonephritis
PFDN2	IgA glomerulonephritis
PFDN4	IgA glomerulonephritis
PFDN5	IgA glomerulonephritis
PFKFB1	IgA glomerulonephritis
PFKFB2	IgA glomerulonephritis
ATP5I	IgA glomerulonephritis
PFKFB4	IgA glomerulonephritis
PFKL	IgA glomerulonephritis
PFKP	IgA glomerulonephritis
PFN2	IgA glomerulonephritis
CDK14	breast cancer
PGC	IgA glomerulonephritis
PGD	IgA glomerulonephritis
PGF	breast cancer
ATP6V1A	IgA glomerulonephritis
PGK2	IgA glomerulonephritis
PGM3	IgA glomerulonephritis
PGM5	prostate cancer
ATP6V1B1	IgA glomerulonephritis
PHF1	breast cancer
PHF2	breast cancer
PHKA1	IgA glomerulonephritis
PHKB	IgA glomerulonephritis
PHKG1	IgA glomerulonephritis
PHKG2	IgA glomerulonephritis
SERPINA4	IgA glomerulonephritis
SERPINB6	IgA glomerulonephritis
ATP6V0C	IgA glomerulonephritis
SERPINE2	IgA glomerulonephritis
SERPINB9	prostate cancer
SERPINB13	IgA glomerulonephritis
PIGC	breast cancer
ATP6V1C1	IgA glomerulonephritis
PIGF	breast cancer
PIK3C2A	IgA glomerulonephritis
PIK3C2B	IgA glomerulonephritis
PIK3C2G	IgA glomerulonephritis
PIK3C3	IgA glomerulonephritis
ATP6V1E1	IgA glomerulonephritis
PIK3CB	IgA glomerulonephritis
PIK3R2	IgA glomerulonephritis
PI4KA	IgA glomerulonephritis
PI4KB	IgA glomerulonephritis
ACP2	IgA glomerulonephritis
PIN4	IgA glomerulonephritis
PIP	prostate cancer
PITPNA	IgA glomerulonephritis
PKLR	obesity
PKNOX1	prostate cancer
PLA2G1B	IgA glomerulonephritis
PLA2G5	IgA glomerulonephritis
PLAG1	IgA glomerulonephritis
ATP6V0B	IgA glomerulonephritis
PLCB2	IgA glomerulonephritis
PLCB3	IgA glomerulonephritis
PLCD1	IgA glomerulonephritis
BTBD1	IgA glomerulonephritis
IL17D	IgA glomerulonephritis
NUDT9	IgA glomerulonephritis
TM6SF1	IgA glomerulonephritis
PANK1	obesity
SHC3	IgA glomerulonephritis
PLCG2	IgA glomerulonephritis
NUP54	IgA glomerulonephritis
TPCN1	IgA glomerulonephritis
PLD2	IgA glomerulonephritis
PLEC	prostate cancer
ATP6V1G2	IgA glomerulonephritis
STX18	IgA glomerulonephritis
SERPINF2	IgA glomerulonephritis
FXYD1	hypertension
ATP6V0A1	IgA glomerulonephritis
PLRG1	human immunodeficiency virus infectious disease
PLTP	prostate cancer
PLXNA1	prostate cancer
ADAM22	autistic disorder
PLXNA2	prostate cancer
BCO1	prostate cancer
S1PR5	IgA glomerulonephritis
PLXNB1	IgA glomerulonephritis
PLXNB3	prostate cancer
ATP6AP1	IgA glomerulonephritis
PMM1	IgA glomerulonephritis
PMP2	prostate cancer
FXYD7	hypertension
FXYD4	hypertension
P2RY13	IgA glomerulonephritis
GPR84	IgA glomerulonephritis
IL20RA	IgA glomerulonephritis
IL20RB	IgA glomerulonephritis
FGFRL1	breast cancer
GPR87	autistic disorder
CLDN22	prostate cancer
DUOX1	prostate cancer
RAB24	IgA glomerulonephritis
PELO	IgA glomerulonephritis
SLCO1C1	prostate cancer
EXOSC9	stomach cancer
EXOSC10	stomach cancer
CNTN5	IgA glomerulonephritis
CSNK1G1	breast cancer
CPSF2	human immunodeficiency virus infectious disease
PNLIP	prostate cancer
PNLIPRP1	IgA glomerulonephritis
PNLIPRP2	IgA glomerulonephritis
PNMT	tyrosinemia
PNN	human immunodeficiency virus infectious disease
GPR88	IgA glomerulonephritis
SEPT4	prostate cancer
H2BFS	IgA glomerulonephritis
NANS	IgA glomerulonephritis
KCNK10	type 2 diabetes mellitus
POLA1	IgA glomerulonephritis
POLD2	IgA glomerulonephritis
POLE	IgA glomerulonephritis
POLE2	IgA glomerulonephritis
POLR2A	peripheral nervous system disease
POLR2B	peripheral nervous system disease
POLR2C	peripheral nervous system disease
GPR173	autistic disorder
GPR85	autistic disorder
POLR2D	peripheral nervous system disease
GNG2	IgA glomerulonephritis
POLR2E	peripheral nervous system disease
DPM3	IgA glomerulonephritis
POLR2F	peripheral nervous system disease
POLR2G	peripheral nervous system disease
CYTL1	IgA glomerulonephritis
POLR2H	peripheral nervous system disease
POLR2I	peripheral nervous system disease
TERF2IP	IgA glomerulonephritis
POLR2J	peripheral nervous system disease
POLR2K	peripheral nervous system disease
POLR2L	peripheral nervous system disease
POLRMT	Alzheimer's disease
TAS2R5	autistic disorder
SSH1	IgA glomerulonephritis
SEMA5B	IgA glomerulonephritis
RIN2	IgA glomerulonephritis
MOV10L1	prostate cancer
TAF7L	peripheral nervous system disease
MRPS21	breast cancer
FBXW5	IgA glomerulonephritis
XRN1	stomach cancer
MIOS	breast cancer
RNF216	IgA glomerulonephritis
PLEKHA5	IgA glomerulonephritis
CHPF2	Ehlers-Danlos syndrome progeroid type
TRMT13	stomach cancer
POU1F1	prostate cancer
UGT2B28	prostate cancer
NEURL1B	breast cancer
TMX3	IgA glomerulonephritis
PRMT7	breast cancer
RBM47	IgA glomerulonephritis
ADAMTSL4	IgA glomerulonephritis
RHOF	IgA glomerulonephritis
POU2F1	stomach cancer
EXOSC4	stomach cancer
DDX4	prostate cancer
MTRF1L	breast cancer
PUS7	stomach cancer
APBB1IP	IgA glomerulonephritis
WDR44	breast cancer
MRPL50	breast cancer
EXOC6	Bardet-Biedl syndrome
NDUFB11	mitochondrial complex I deficiency
POU3F2	breast cancer
TOMM7	IgA glomerulonephritis
GNL3L	IgA glomerulonephritis
DDX49	stomach cancer
EPB41L4B	prostate cancer
UGT1A7	prostate cancer
UGT1A5	prostate cancer
POU4F2	breast cancer
EGLN1	IgA glomerulonephritis
GNB1L	IgA glomerulonephritis
UGT1A9	prostate cancer
INO80	IgA glomerulonephritis
POU5F1B	breast cancer
PAF1	peripheral nervous system disease
PARP14	IgA glomerulonephritis
POU6F1	breast cancer
PPA1	IgA glomerulonephritis
UGT1A3	prostate cancer
TBC1D13	IgA glomerulonephritis
CRLS1	IgA glomerulonephritis
GTPBP2	IgA glomerulonephritis
CROT	prostate cancer
RRN3	breast cancer
PDP1	obesity
TMED9	IgA glomerulonephritis
RAB39A	IgA glomerulonephritis
LY6K	IgA glomerulonephritis
PPEF1	retinitis pigmentosa
FBLIM1	prostate cancer
CTSA	IgA glomerulonephritis
ROPN1	IgA glomerulonephritis
ZRANB1	IgA glomerulonephritis
BTG4	stomach cancer
PPP1R12C	IgA glomerulonephritis
NSMCE4A	IgA glomerulonephritis
DNAJB12	prostate cancer
MED18	prostate cancer
MBTD1	breast cancer
HAUS6	IgA glomerulonephritis
TRIT1	stomach cancer
ZNF586	breast cancer
PPID	IgA glomerulonephritis
ZNF562	breast cancer
GATAD2A	breast cancer
ERCC6L	IgA glomerulonephritis
ASPN	prostate cancer
NUP62CL	IgA glomerulonephritis
BEST2	IgA glomerulonephritis
APTX	hypertension
SYTL2	IgA glomerulonephritis
ESRP1	breast cancer
ARHGEF38	IgA glomerulonephritis
FBXL12	IgA glomerulonephritis
PAQR5	IgA glomerulonephritis
ELP6	breast cancer
SLX1A	breast cancer
CKMT1A	prostate cancer
CC2D1A	IgA glomerulonephritis
TOR4A	IgA glomerulonephritis
POLR2J3	IgA glomerulonephritis
PIGG	breast cancer
FNBP1L	IgA glomerulonephritis
CWC25	human immunodeficiency virus infectious disease
TBC1D8B	IgA glomerulonephritis
PLPPR1	IgA glomerulonephritis
ALKBH5	IgA glomerulonephritis
INO80D	IgA glomerulonephritis
NCAPG2	IgA glomerulonephritis
PQLC2	prostate cancer
AUH	maple syrup urine disease
LAX1	IgA glomerulonephritis
CYP2W1	prostate cancer
SEMA4C	IgA glomerulonephritis
RPP25	stomach cancer
CMTM6	IgA glomerulonephritis
DUS2	stomach cancer
CHTF8	IgA glomerulonephritis
LIME1	IgA glomerulonephritis
ZSCAN32	breast cancer
UBE2R2	IgA glomerulonephritis
PPL	prostate cancer
HAUS4	IgA glomerulonephritis
TRMT10C	stomach cancer
RHBDL2	human immunodeficiency virus infectious disease
KANSL2	breast cancer
SARS2	IgA glomerulonephritis
PPM1A	breast cancer
RNF125	IgA glomerulonephritis
MRPL16	breast cancer
TRNAU1AP	prostate cancer
PPM1G	human immunodeficiency virus infectious disease
GEMIN8	human immunodeficiency virus infectious disease
SSH3	IgA glomerulonephritis
TIPIN	breast cancer
UCKL1	breast cancer
C1orf56	IgA glomerulonephritis
PIGX	breast cancer
BANP	breast cancer
HRASLS2	IgA glomerulonephritis
NMRK1	obesity
PINX1	breast cancer
ACSM5	lung benign neoplasm
ZNF770	breast cancer
PPP1CA	IgA glomerulonephritis
OXSM	obesity
MARC2	prostate cancer
AURKAIP1	breast cancer
ACPP	IgA glomerulonephritis
PPP1CB	IgA glomerulonephritis
PAK1IP1	IgA glomerulonephritis
LAMTOR1	IgA glomerulonephritis
TRMT61B	stomach cancer
PPP2R3C	IgA glomerulonephritis
USP47	IgA glomerulonephritis
FKBP14	prostate cancer
PTCD3	breast cancer
TRMT12	stomach cancer
EPN3	IgA glomerulonephritis
VPS37C	IgA glomerulonephritis
MRPL20	breast cancer
ZWILCH	IgA glomerulonephritis
PDPR	obesity
PPP1R3C	IgA glomerulonephritis
DET1	IgA glomerulonephritis
RNF31	IgA glomerulonephritis
IFT57	Bardet-Biedl syndrome
KIF26B	IgA glomerulonephritis
SLC38A4	hypertension
PPP1R3D	IgA glomerulonephritis
MED9	prostate cancer
PPP1R7	IgA glomerulonephritis
ANO1	hypertension
MAGOHB	human immunodeficiency virus infectious disease
WDR60	Bardet-Biedl syndrome
ARHGAP17	IgA glomerulonephritis
SLC6A15	IgA glomerulonephritis
PRPF38B	human immunodeficiency virus infectious disease
PIWIL2	prostate cancer
CEP192	IgA glomerulonephritis
HEATR1	dyskeratosis congenita
TRIM68	prostate cancer
RBM28	dyskeratosis congenita
ELP3	breast cancer
HAUS2	IgA glomerulonephritis
CDCA8	IgA glomerulonephritis
DARS2	IgA glomerulonephritis
PPP2CB	IgA glomerulonephritis
ARHGEF10L	IgA glomerulonephritis
CENPQ	IgA glomerulonephritis
MSL2	breast cancer
MRPS18A	breast cancer
PRMT6	breast cancer
MRPS10	breast cancer
INTS10	IgA glomerulonephritis
KLHL11	IgA glomerulonephritis
SEC61A2	prostate cancer
MRM3	stomach cancer
FAIM	IgA glomerulonephritis
SMG8	Diamond-Blackfan anemia
RNF220	IgA glomerulonephritis
RIF1	breast cancer
NUDT11	IgA glomerulonephritis
NADSYN1	obesity
PPP2R2A	IgA glomerulonephritis
PLEKHG6	IgA glomerulonephritis
LGI2	autistic disorder
DPPA4	breast cancer
P3H2	IgA glomerulonephritis
TMLHE	prostate cancer
PPP2R2C	IgA glomerulonephritis
ETNK2	IgA glomerulonephritis
RAVER2	IgA glomerulonephritis
NAT10	dyskeratosis congenita
PANK4	obesity
PPP2R3A	IgA glomerulonephritis
MOB1A	IgA glomerulonephritis
SMU1	IgA glomerulonephritis
UBA6	IgA glomerulonephritis
STEAP3	IgA glomerulonephritis
KIRREL	prostate cancer
PPP2R5A	IgA glomerulonephritis
ELP2	breast cancer
TYW1	stomach cancer
MRGBP	breast cancer
PPP2R5B	IgA glomerulonephritis
ECHDC2	obesity
NUDT15	IgA glomerulonephritis
IMP3	dyskeratosis congenita
PGM2	IgA glomerulonephritis
QRSL1	IgA glomerulonephritis
PPP2R5D	IgA glomerulonephritis
MCOLN3	hypertension
UBE2W	IgA glomerulonephritis
RHOT1	IgA glomerulonephritis
PPP2R5E	IgA glomerulonephritis
BRF2	Treacher Collins syndrome
PPP6R3	IgA glomerulonephritis
UEVLD	IgA glomerulonephritis
BRIX1	IgA glomerulonephritis
AVPR1B	IgA glomerulonephritis
PI4K2B	IgA glomerulonephritis
OLAH	obesity
PPP4C	breast cancer
CPPED1	IgA glomerulonephritis
MIS18BP1	IgA glomerulonephritis
AGPAT5	IgA glomerulonephritis
LIN7C	autistic disorder
PPP3CC	IgA glomerulonephritis
BLOC1S4	IgA glomerulonephritis
SLC39A9	prostate cancer
FBXL8	IgA glomerulonephritis
WDR33	human immunodeficiency virus infectious disease
LSG1	dyskeratosis congenita
SLC35C1	IgA glomerulonephritis
ABHD10	prostate cancer
CHDH	prostate cancer
PPP3R2	IgA glomerulonephritis
COPRS	breast cancer
LAPTM4B	IgA glomerulonephritis
SLC22A15	prostate cancer
STYK1	IgA glomerulonephritis
PPP5C	IgA glomerulonephritis
PI4K2A	IgA glomerulonephritis
TMEM63B	IgA glomerulonephritis
LGR4	breast cancer
PPT1	obesity
MCM10	Meier-Gorlin syndrome
PPY	IgA glomerulonephritis
NPY4R	IgA glomerulonephritis
PRB1	IgA glomerulonephritis
HIST2H4B	IgA glomerulonephritis
YOD1	IgA glomerulonephritis
STRADB	breast cancer
CSGALNACT2	Ehlers-Danlos syndrome progeroid type
PRCP	IgA glomerulonephritis
NDUFAF7	mitochondrial complex I deficiency
PRELP	IgA glomerulonephritis
CHST12	Ehlers-Danlos syndrome progeroid type
HES6	breast cancer
H2AFY2	IgA glomerulonephritis
GPRC5D	autistic disorder
ASIC4	IgA glomerulonephritis
ELAC1	human immunodeficiency virus infectious disease
TRIM36	IgA glomerulonephritis
DHTKD1	obesity
TMEM55A	IgA glomerulonephritis
PRG2	IgA glomerulonephritis
CDCA7L	prostate cancer
PRH1	IgA glomerulonephritis
IL17RB	IgA glomerulonephritis
PRH2	IgA glomerulonephritis
SOX6	breast cancer
KLK15	prostate cancer
ENOSF1	IgA glomerulonephritis
HAUS7	IgA glomerulonephritis
DNAH3	IgA glomerulonephritis
GALNT10	IgA glomerulonephritis
PRIM1	IgA glomerulonephritis
CNOT11	breast cancer
CDV3	IgA glomerulonephritis
STAB2	IgA glomerulonephritis
SUPT20H	breast cancer
PRIM2	IgA glomerulonephritis
KIF27	IgA glomerulonephritis
CHRNA9	autistic disorder
UBE2Q1	IgA glomerulonephritis
MIOX	IgA glomerulonephritis
MED29	prostate cancer
BMP2K	breast cancer
VEZT	IgA glomerulonephritis
OTUD5	IgA glomerulonephritis
RNPC3	human immunodeficiency virus infectious disease
CARMIL1	IgA glomerulonephritis
OTUB1	IgA glomerulonephritis
MTMR8	IgA glomerulonephritis
KIF16B	IgA glomerulonephritis
PRR5	IgA glomerulonephritis
ASAP3	IgA glomerulonephritis
STAP2	IgA glomerulonephritis
TRMT1	stomach cancer
POMGNT1	IgA glomerulonephritis
AMBRA1	IgA glomerulonephritis
SMPD4	IgA glomerulonephritis
KRBOX4	breast cancer
RAB20	IgA glomerulonephritis
PRKAB2	IgA glomerulonephritis
PIGV	breast cancer
NLRP2	IgA glomerulonephritis
ZNF692	breast cancer
RNF126	IgA glomerulonephritis
ZNF416	breast cancer
PRPF40A	human immunodeficiency virus infectious disease
HIF1AN	breast cancer
CDC37L1	IgA glomerulonephritis
NPLOC4	IgA glomerulonephritis
DENND4C	IgA glomerulonephritis
MFN1	IgA glomerulonephritis
PPP4R3A	IgA glomerulonephritis
IWS1	peripheral nervous system disease
LIMS2	prostate cancer
PRKACG	IgA glomerulonephritis
KANSL3	breast cancer
YEATS2	breast cancer
PKIA	IgA glomerulonephritis
KDM4D	breast cancer
RBM22	human immunodeficiency virus infectious disease
VAC14	IgA glomerulonephritis
PKIB	prostate cancer
ARHGEF40	IgA glomerulonephritis
POLR3B	Treacher Collins syndrome
CCDC88A	breast cancer
NECAP2	IgA glomerulonephritis
PRKAG1	IgA glomerulonephritis
FAR2	prostate cancer
ZNF334	breast cancer
DOK4	prostate cancer
POLR3E	Treacher Collins syndrome
ASUN	IgA glomerulonephritis
EDEM2	IgA glomerulonephritis
NUP133	IgA glomerulonephritis
CCAR1	human immunodeficiency virus infectious disease
PRKAR1B	IgA glomerulonephritis
AGK	IgA glomerulonephritis
SEPT11	IgA glomerulonephritis
OGDHL	obesity
INTS9	IgA glomerulonephritis
UGGT2	IgA glomerulonephritis
PRKAR2A	IgA glomerulonephritis
ZNF701	breast cancer
H2AFJ	IgA glomerulonephritis
NGLY1	IgA glomerulonephritis
TDP1	IgA glomerulonephritis
MBD5	IgA glomerulonephritis
ZNF839	breast cancer
RIOK2	dyskeratosis congenita
ZNF415	breast cancer
TXLNG	prostate cancer
LMBRD1	prostate cancer
DEPDC1B	IgA glomerulonephritis
CSGALNACT1	Ehlers-Danlos syndrome progeroid type
CACNA2D3	prostate cancer
DCP1A	stomach cancer
ADAP2	IgA glomerulonephritis
ST6GALNAC1	IgA glomerulonephritis
ADCY10	breast cancer
UTP6	dyskeratosis congenita
BDP1	Treacher Collins syndrome
DOK5	prostate cancer
KDM3A	breast cancer
PECR	obesity
CAND1	IgA glomerulonephritis
CENPJ	IgA glomerulonephritis
PRKCI	IgA glomerulonephritis
ARHGAP15	IgA glomerulonephritis
PPP2R2D	IgA glomerulonephritis
BRK1	IgA glomerulonephritis
CISD1	prostate cancer
PKN1	IgA glomerulonephritis
USE1	IgA glomerulonephritis
PSENEN	breast cancer
ACOT13	prostate cancer
BEX1	prostate cancer
PKN2	IgA glomerulonephritis
ACTR10	IgA glomerulonephritis
TMEM126B	mitochondrial complex I deficiency
SLC22A11	prostate cancer
ASH1L	breast cancer
GABRQ	autistic disorder
ZKSCAN7	breast cancer
GPRC5C	autistic disorder
DEFB103B	IgA glomerulonephritis
MESP1	breast cancer
ZNF302	breast cancer
THSD1	IgA glomerulonephritis
ACSS2	obesity
CMAS	IgA glomerulonephritis
ANGPTL8	prostate cancer
APOBR	prostate cancer
RCC2	IgA glomerulonephritis
DMAP1	breast cancer
PRKG2	IgA glomerulonephritis
ZMAT5	human immunodeficiency virus infectious disease
LIN37	IgA glomerulonephritis
KLHL9	IgA glomerulonephritis
MAPK4	IgA glomerulonephritis
SEPT3	IgA glomerulonephritis
NDUFA12	mitochondrial complex I deficiency
NSFL1C	prostate cancer
MAPK6	IgA glomerulonephritis
MAPK7	IgA glomerulonephritis
NXF5	human immunodeficiency virus infectious disease
NXF3	human immunodeficiency virus infectious disease
NXF2	human immunodeficiency virus infectious disease
MYDGF	prostate cancer
SMG9	Diamond-Blackfan anemia
MAPK10	IgA glomerulonephritis
ALG1	IgA glomerulonephritis
MAP2K3	IgA glomerulonephritis
PRKX	IgA glomerulonephritis
NSMCE3	IgA glomerulonephritis
TDRD1	prostate cancer
DNAH7	mitochondrial complex I deficiency
PSPN	IgA glomerulonephritis
ZNF253	breast cancer
KIAA1217	IgA glomerulonephritis
CRTAM	IgA glomerulonephritis
RNF20	IgA glomerulonephritis
CTNNBL1	human immunodeficiency virus infectious disease
GPCPD1	IgA glomerulonephritis
KYAT3	prostate cancer
WDR45B	IgA glomerulonephritis
PARD3	prostate cancer
IL36G	IgA glomerulonephritis
SLC7A10	IgA glomerulonephritis
TRPV5	IgA glomerulonephritis
PRPS1	IgA glomerulonephritis
METTL3	human immunodeficiency virus infectious disease
PRPS2	IgA glomerulonephritis
LGMN	IgA glomerulonephritis
LTB4R2	IgA glomerulonephritis
PRSS2	IgA glomerulonephritis
CTPS2	IgA glomerulonephritis
CCL28	IgA glomerulonephritis
KLK7	prostate cancer
KLK6	IgA glomerulonephritis
CHST7	Ehlers-Danlos syndrome progeroid type
AZU1	IgA glomerulonephritis
ERO1B	IgA glomerulonephritis
PSD	IgA glomerulonephritis
EIF5A2	IgA glomerulonephritis
TMPRSS4	IgA glomerulonephritis
C10orf2	Alzheimer's disease
POLE4	IgA glomerulonephritis
OR2S2	IgA glomerulonephritis
TRIM39	IgA glomerulonephritis
KCNK13	type 2 diabetes mellitus
KCNK12	type 2 diabetes mellitus
PANX2	hypertension
MUC13	IgA glomerulonephritis
SUCNR1	IgA glomerulonephritis
SAR1A	prostate cancer
PSG1	IgA glomerulonephritis
PSG2	IgA glomerulonephritis
PSG3	IgA glomerulonephritis
PSG4	IgA glomerulonephritis
SLC2A4RG	IgA glomerulonephritis
PSG6	IgA glomerulonephritis
PSG7	IgA glomerulonephritis
PSG9	IgA glomerulonephritis
PSG11	IgA glomerulonephritis
PSKH1	human immunodeficiency virus infectious disease
PSMA1	human immunodeficiency virus infectious disease
ZC3HAV1	IgA glomerulonephritis
IFNK	IgA glomerulonephritis
PSMA3	human immunodeficiency virus infectious disease
RAD18	IgA glomerulonephritis
CELF4	human immunodeficiency virus infectious disease
PSMA7	human immunodeficiency virus infectious disease
UGGT1	IgA glomerulonephritis
KCMF1	IgA glomerulonephritis
UBQLN4	prostate cancer
AGPAT4	IgA glomerulonephritis
DPYSL5	prostate cancer
BDH2	obesity
PAPOLB	IgA glomerulonephritis
SH3GLB2	IgA glomerulonephritis
SPIRE1	breast cancer
PSMB3	human immunodeficiency virus infectious disease
IFT46	Bardet-Biedl syndrome
C1GALT1	IgA glomerulonephritis
SMARCAD1	breast cancer
DHX33	IgA glomerulonephritis
SEMA3G	IgA glomerulonephritis
NMUR2	IgA glomerulonephritis
PMEPA1	IgA glomerulonephritis
PSMB6	human immunodeficiency virus infectious disease
DUSP22	IgA glomerulonephritis
ENY2	breast cancer
XAB2	IgA glomerulonephritis
SMYD2	breast cancer
NT5M	IgA glomerulonephritis
NIT2	IgA glomerulonephritis
OTUD7B	IgA glomerulonephritis
RGMA	prostate cancer
ATXN7L3	breast cancer
PRDM9	IgA glomerulonephritis
PSMB9	human immunodeficiency virus infectious disease
POGLUT1	IgA glomerulonephritis
ADPRM	IgA glomerulonephritis
TOMM22	IgA glomerulonephritis
CTNNBIP1	breast cancer
BAAT	prostate cancer
PSMC1	human immunodeficiency virus infectious disease
PSMC2	human immunodeficiency virus infectious disease
COQ9	multiple system atrophy
CIAPIN1	prostate cancer
C16orf62	IgA glomerulonephritis
PDXP	status epilepticus
PSMC4	human immunodeficiency virus infectious disease
UTP3	dyskeratosis congenita
CHRNA10	autistic disorder
TBX20	breast cancer
PSMC6	human immunodeficiency virus infectious disease
PCBP4	IgA glomerulonephritis
PSMD1	human immunodeficiency virus infectious disease
PSMD2	human immunodeficiency virus infectious disease
AGTRAP	IgA glomerulonephritis
ENTPD7	IgA glomerulonephritis
PSMD4	human immunodeficiency virus infectious disease
NAT14	prostate cancer
PDSS2	multiple system atrophy
PSMD5	human immunodeficiency virus infectious disease
HRASLS	IgA glomerulonephritis
TRPC7	IgA glomerulonephritis
PGLYRP4	IgA glomerulonephritis
INTS12	IgA glomerulonephritis
EPPIN	IgA glomerulonephritis
LPAR5	IgA glomerulonephritis
NUP107	IgA glomerulonephritis
CD177	IgA glomerulonephritis
RHBG	IgA glomerulonephritis
LYRM4	Friedreich ataxia
MRPL47	breast cancer
PSMD7	human immunodeficiency virus infectious disease
ATP13A1	autistic disorder
CHMP1B	IgA glomerulonephritis
MAN1C1	IgA glomerulonephritis
RTN4	IgA glomerulonephritis
PAK5	IgA glomerulonephritis
RALGAPB	IgA glomerulonephritis
PSMD9	human immunodeficiency virus infectious disease
SLC44A2	IgA glomerulonephritis
SMURF1	IgA glomerulonephritis
PSMD10	human immunodeficiency virus infectious disease
PELI2	IgA glomerulonephritis
GJC2	hypertension
ZNFX1	breast cancer
PSMD11	human immunodeficiency virus infectious disease
DOLPP1	IgA glomerulonephritis
CAMK1G	prostate cancer
VARS2	IgA glomerulonephritis
SLC39A10	IgA glomerulonephritis
RALGAPA2	IgA glomerulonephritis
THOC2	human immunodeficiency virus infectious disease
ADAMTSL3	IgA glomerulonephritis
VN1R1	IgA glomerulonephritis
ATP8B2	IgA glomerulonephritis
ATP10D	autistic disorder
ZNF248	breast cancer
CEMIP	IgA glomerulonephritis
PPP4R3B	IgA glomerulonephritis
SMAGP	IgA glomerulonephritis
PTBP1	breast cancer
TAS2R38	autistic disorder
PTGDR	prostate cancer
KIR2DL5A	IgA glomerulonephritis
PTGDS	prostate cancer
KAT14	breast cancer
CBX8	IgA glomerulonephritis
ZNF286A	breast cancer
ZNF287	breast cancer
ZNF304	breast cancer
TTYH1	hypertension
MRS2	prostate cancer
CLK4	human immunodeficiency virus infectious disease
DHFRP1	phenylketonuria
S100A14	IgA glomerulonephritis
RAB22A	IgA glomerulonephritis
CYP20A1	prostate cancer
ABHD6	IgA glomerulonephritis
NMRAL1	prostate cancer
SCYL1	IgA glomerulonephritis
TMIGD3	breast cancer
BIRC6	IgA glomerulonephritis
GALNT16	IgA glomerulonephritis
DSCAML1	prostate cancer
GATAD2B	breast cancer
PTH2R	IgA glomerulonephritis
ISY1	IgA glomerulonephritis
KIAA1161	breast cancer
CNOT6	stomach cancer
ZNF490	breast cancer
SHROOM4	prostate cancer
USP31	IgA glomerulonephritis
NLN	IgA glomerulonephritis
ESYT2	IgA glomerulonephritis
AHRR	prostate cancer
RIMKLB	autistic disorder
LRFN2	autistic disorder
KIDINS220	IgA glomerulonephritis
ADGRB1	IgA glomerulonephritis
MTA3	breast cancer
AARS2	IgA glomerulonephritis
MAVS	IgA glomerulonephritis
INTS2	IgA glomerulonephritis
XPO5	IgA glomerulonephritis
CASKIN2	IgA glomerulonephritis
SERINC1	prostate cancer
HECW2	IgA glomerulonephritis
PTK6	IgA glomerulonephritis
CGN	IgA glomerulonephritis
NUFIP2	IgA glomerulonephritis
TBC1D14	IgA glomerulonephritis
MIB1	breast cancer
DISP3	holoprosencephaly
ZNF398	breast cancer
KLHL42	IgA glomerulonephritis
CC2D2A	Bardet-Biedl syndrome
PDP2	obesity
ZNF624	breast cancer
TAOK1	IgA glomerulonephritis
NCEH1	prostate cancer
LRRC7	IgA glomerulonephritis
NLGN2	autistic disorder
SEMA6A	prostate cancer
STAMBPL1	IgA glomerulonephritis
TRMT5	stomach cancer
CARNS1	prostate cancer
ZNF471	breast cancer
UNC79	hypertension
PREX1	IgA glomerulonephritis
ARHGAP21	IgA glomerulonephritis
RIC1	IgA glomerulonephritis
WDFY1	IgA glomerulonephritis
BEGAIN	autistic disorder
WDR48	IgA glomerulonephritis
FNIP2	breast cancer
KIAA1456	stomach cancer
PITPNM2	IgA glomerulonephritis
ZNF492	breast cancer
STIM2	IgA glomerulonephritis
ZBTB2	breast cancer
LRFN1	autistic disorder
SH3RF1	IgA glomerulonephritis
EP400	breast cancer
PTN	breast cancer
COL20A1	IgA glomerulonephritis
MYH7B	prostate cancer
USP28	IgA glomerulonephritis
DHX37	dyskeratosis congenita
UVSSA	IgA glomerulonephritis
HCN3	epilepsy
CAMSAP3	IgA glomerulonephritis
PLEKHA4	IgA glomerulonephritis
RDH14	stomach cancer
EPB41L5	autistic disorder
ZFP14	breast cancer
ALS2	IgA glomerulonephritis
LRRC4C	IgA glomerulonephritis
TNRC6C	IgA glomerulonephritis
ZNF317	breast cancer
USP37	IgA glomerulonephritis
SHTN1	IgA glomerulonephritis
CWC22	human immunodeficiency virus infectious disease
GBA2	IgA glomerulonephritis
ZNF529	breast cancer
SEMA4G	IgA glomerulonephritis
METTL14	human immunodeficiency virus infectious disease
WDR19	Bardet-Biedl syndrome
ZFYVE28	IgA glomerulonephritis
PTPN4	IgA glomerulonephritis
SCUBE2	IgA glomerulonephritis
ANKRA2	IgA glomerulonephritis
PTPN7	IgA glomerulonephritis
RBAK	prostate cancer
MARK4	breast cancer
SUGP1	human immunodeficiency virus infectious disease
RAB40C	IgA glomerulonephritis
PTPN9	IgA glomerulonephritis
POLD4	IgA glomerulonephritis
CCAR2	IgA glomerulonephritis
LSM2	human immunodeficiency virus infectious disease
SLAMF7	IgA glomerulonephritis
RAP2C	IgA glomerulonephritis
CATSPERG	pneumoconiosis
ZP4	pneumoconiosis
CYP4F11	prostate cancer
SLC4A5	IgA glomerulonephritis
CADM3	prostate cancer
MUC3B	IgA glomerulonephritis
NKX3-2	prostate cancer
PTPRCAP	IgA glomerulonephritis
PTPRH	IgA glomerulonephritis
PTPRM	prostate cancer
PTPRN	IgA glomerulonephritis
PTPRS	autistic disorder
PTS	phenylketonuria
RAD1	IgA glomerulonephritis
PURA	IgA glomerulonephritis
PTBP2	IgA glomerulonephritis
NECTIN1	prostate cancer
CTDSP1	IgA glomerulonephritis
CXCL16	IgA glomerulonephritis
PWP2	dyskeratosis congenita
PXMP2	IgA glomerulonephritis
ALDH18A1	prostate cancer
PCYT2	IgA glomerulonephritis
SQRDL	prostate cancer
SRPRB	prostate cancer
ENOPH1	prostate cancer
RHOU	IgA glomerulonephritis
NLRC4	IgA glomerulonephritis
TRAPPC1	IgA glomerulonephritis
PCTP	prostate cancer
RPRD1B	IgA glomerulonephritis
ZNF71	breast cancer
ZNF77	breast cancer
PRUNE1	IgA glomerulonephritis
ZNF462	breast cancer
ZNF250	breast cancer
PRODH2	autistic disorder
DNASE2B	IgA glomerulonephritis
DLGAP3	autistic disorder
SELENOK	prostate cancer
RBM25	human immunodeficiency virus infectious disease
MID1IP1	prostate cancer
RRAGD	breast cancer
LY6G6D	IgA glomerulonephritis
SNX6	IgA glomerulonephritis
RAB1A	IgA glomerulonephritis
RGL2	IgA glomerulonephritis
RAB3B	IgA glomerulonephritis
RAB3IL1	IgA glomerulonephritis
RAB4A	IgA glomerulonephritis
RAB6A	IgA glomerulonephritis
MAP4K2	IgA glomerulonephritis
RAB13	IgA glomerulonephritis
RAB27B	IgA glomerulonephritis
RABGGTA	IgA glomerulonephritis
RABGGTB	IgA glomerulonephritis
RABIF	IgA glomerulonephritis
RAB5C	IgA glomerulonephritis
RAC3	IgA glomerulonephritis
RAD9A	IgA glomerulonephritis
RAD17	IgA glomerulonephritis
RAD52	IgA glomerulonephritis
RALA	IgA glomerulonephritis
IL22RA1	IgA glomerulonephritis
RALB	IgA glomerulonephritis
RALGDS	IgA glomerulonephritis
RANBP2	IgA glomerulonephritis
RANGAP1	IgA glomerulonephritis
RAP1B	IgA glomerulonephritis
CARD18	IgA glomerulonephritis
RAP1GDS1	IgA glomerulonephritis
RAP2B	IgA glomerulonephritis
RARRES3	IgA glomerulonephritis
ARID4A	breast cancer
KDM5A	breast cancer
NTN4	prostate cancer
RBBP4	IgA glomerulonephritis
CACNG8	prostate cancer
CACNG7	prostate cancer
CACNG6	IgA glomerulonephritis
RBBP5	breast cancer
RBBP6	IgA glomerulonephritis
SIGIRR	IgA glomerulonephritis
RBBP7	IgA glomerulonephritis
RBL1	IgA glomerulonephritis
PLEKHA1	IgA glomerulonephritis
PLEKHA2	IgA glomerulonephritis
SENP2	IgA glomerulonephritis
GNB4	IgA glomerulonephritis
ZNF350	breast cancer
KLHL12	breast cancer
RBP2	stomach cancer
CPLX3	autistic disorder
RCN2	IgA glomerulonephritis
RCVRN	retinitis pigmentosa
REG1A	IgA glomerulonephritis
RELB	IgA glomerulonephritis
UPF1	Diamond-Blackfan anemia
DPF2	prostate cancer
RFC3	IgA glomerulonephritis
RFC4	IgA glomerulonephritis
RFC5	IgA glomerulonephritis
RFNG	IgA glomerulonephritis
BCL2L2	prostate cancer
RFX5	IgA glomerulonephritis
RFXAP	IgA glomerulonephritis
RGS3	IgA glomerulonephritis
RGS10	breast cancer
RGS12	breast cancer
RGS13	breast cancer
RGS16	IgA glomerulonephritis
RHAG	IgA glomerulonephritis
RLN1	prostate cancer
RING1	IgA glomerulonephritis
BCL3	IgA glomerulonephritis
SLC25A19	prostate cancer
TGIF2	breast cancer
RNF2	IgA glomerulonephritis
RNF4	IgA glomerulonephritis
RNF5	IgA glomerulonephritis
ELOVL5	prostate cancer
SLC5A7	IgA glomerulonephritis
SAV1	IgA glomerulonephritis
TRMT11	stomach cancer
MRPS35	breast cancer
APOBEC3G	IgA glomerulonephritis
PPCDC	obesity
AASDHPPT	prostate cancer
BCL7A	IgA glomerulonephritis
SPCS3	obesity
NAA35	IgA glomerulonephritis
RINT1	IgA glomerulonephritis
SCOC	IgA glomerulonephritis
KCNK15	type 2 diabetes mellitus
RIC8A	autistic disorder
CYB5RL	IgA glomerulonephritis
ATG101	IgA glomerulonephritis
PAPPA2	prostate cancer
SMAP1	IgA glomerulonephritis
TRAPPC11	IgA glomerulonephritis
TNFRSF17	IgA glomerulonephritis
ROCK1	IgA glomerulonephritis
HCN2	autistic disorder
RPA1	IgA glomerulonephritis
RPA2	IgA glomerulonephritis
RPA3	IgA glomerulonephritis
RPL3	Diamond-Blackfan anemia
RPL3L	Diamond-Blackfan anemia
RPL4	Diamond-Blackfan anemia
RPL7	Diamond-Blackfan anemia
RPL7A	Diamond-Blackfan anemia
RPL8	Diamond-Blackfan anemia
DEFB135	IgA glomerulonephritis
DEFB136	IgA glomerulonephritis
DEFB134	IgA glomerulonephritis
RPL9	Diamond-Blackfan anemia
RPL18A	Diamond-Blackfan anemia
RPL19	Diamond-Blackfan anemia
RPL21	Diamond-Blackfan anemia
RPL22	Diamond-Blackfan anemia
MRPL23	breast cancer
RPL24	Diamond-Blackfan anemia
RPL27	Diamond-Blackfan anemia
RPL30	Diamond-Blackfan anemia
RPL28	Diamond-Blackfan anemia
RPL29	Diamond-Blackfan anemia
RPL32	Diamond-Blackfan anemia
RPL34	Diamond-Blackfan anemia
RPL36AL	Diamond-Blackfan anemia
RPL37	Diamond-Blackfan anemia
RPL38	Diamond-Blackfan anemia
RPL39	Diamond-Blackfan anemia
RPL41	Diamond-Blackfan anemia
RPL36A	Diamond-Blackfan anemia
RPLP0	Diamond-Blackfan anemia
RPLP1	Diamond-Blackfan anemia
RPLP2	Diamond-Blackfan anemia
MRPL12	breast cancer
MRPS12	breast cancer
RPN1	IgA glomerulonephritis
RPS2	Diamond-Blackfan anemia
RPS3A	Diamond-Blackfan anemia
SERINC4	prostate cancer
RPS4Y1	Diamond-Blackfan anemia
ZNF704	breast cancer
RPS5	Diamond-Blackfan anemia
MBOAT4	obesity
RPS9	Diamond-Blackfan anemia
RPS11	Diamond-Blackfan anemia
RPS12	Diamond-Blackfan anemia
RPS13	Diamond-Blackfan anemia
RPS14	Diamond-Blackfan anemia
RPS15A	Diamond-Blackfan anemia
RPS16	Diamond-Blackfan anemia
BDH1	obesity
RPS18	Diamond-Blackfan anemia
RPS23	Diamond-Blackfan anemia
RPS25	Diamond-Blackfan anemia
RPS27	Diamond-Blackfan anemia
RPS27A	IgA glomerulonephritis
RRBP1	prostate cancer
RTKN	IgA glomerulonephritis
RSC1A1	IgA glomerulonephritis
CLIP1	IgA glomerulonephritis
RYR3	IgA glomerulonephritis
S100A2	IgA glomerulonephritis
S100A11	IgA glomerulonephritis
SAA2	prostate cancer
SAA4	prostate cancer
SAFB	prostate cancer
SALL1	breast cancer
MAPK12	IgA glomerulonephritis
SARS	prostate cancer
SATB1	IgA glomerulonephritis
MSMO1	porokeratosis
SCN2B	prostate cancer
SCNN1D	hypertension
SCTR	prostate cancer
CCL13	IgA glomerulonephritis
CCL14	IgA glomerulonephritis
CCL15	IgA glomerulonephritis
BICD1	IgA glomerulonephritis
CCL16	IgA glomerulonephritis
CCL23	IgA glomerulonephritis
CCL25	IgA glomerulonephritis
XCL1	IgA glomerulonephritis
BIK	prostate cancer
SDC1	IgA glomerulonephritis
BCAN	IgA glomerulonephritis
SDC2	IgA glomerulonephritis
SDCBP	IgA glomerulonephritis
ABHD4	IgA glomerulonephritis
MRPL17	breast cancer
RNF123	IgA glomerulonephritis
UBE2O	IgA glomerulonephritis
NAPB	IgA glomerulonephritis
ELMO2	IgA glomerulonephritis
GALNT11	IgA glomerulonephritis
CHTF18	IgA glomerulonephritis
TNN	prostate cancer
CHP2	prostate cancer
MRPS14	breast cancer
ZNF667	breast cancer
SEC13	IgA glomerulonephritis
CLSPN	IgA glomerulonephritis
SEC14L1	prostate cancer
TP53AIP1	breast cancer
KIF13A	IgA glomerulonephritis
NEUROG2	prostate cancer
ANO3	hypertension
SEL1L	IgA glomerulonephritis
ERVK-6	IgA glomerulonephritis
SELPLG	IgA glomerulonephritis
SEMG1	IgA glomerulonephritis
OXCT2	obesity
PERP	breast cancer
MMP27	prostate cancer
LHPP	IgA glomerulonephritis
SLC28A3	IgA glomerulonephritis
RBKS	IgA glomerulonephritis
GOLPH3	breast cancer
MCCC2	maple syrup urine disease
GAL3ST2	prostate cancer
GFRA4	IgA glomerulonephritis
PARVG	IgA glomerulonephritis
ELSPBP1	IgA glomerulonephritis
LRRC4	IgA glomerulonephritis
CENPK	IgA glomerulonephritis
NPFFR1	IgA glomerulonephritis
CRLF2	IgA glomerulonephritis
RRAGC	breast cancer
FN3K	IgA glomerulonephritis
ADGRL4	lung disease
LIN7B	autistic disorder
ABCG4	prostate cancer
ACOT6	prostate cancer
RBSN	IgA glomerulonephritis
KIF9	IgA glomerulonephritis
MAP2K4	IgA glomerulonephritis
DPEP2	prostate cancer
SET	IgA glomerulonephritis
DPEP3	prostate cancer
SETMAR	breast cancer
LHX5	breast cancer
TFB2M	Alzheimer's disease
PJA1	IgA glomerulonephritis
MLST8	IgA glomerulonephritis
SFRP4	breast cancer
SRSF2	human immunodeficiency virus infectious disease
SRSF3	human immunodeficiency virus infectious disease
PAPD5	stomach cancer
ARHGEF28	IgA glomerulonephritis
RAB17	IgA glomerulonephritis
SRSF4	human immunodeficiency virus infectious disease
SRSF6	human immunodeficiency virus infectious disease
SRSF7	human immunodeficiency virus infectious disease
RNF25	IgA glomerulonephritis
SOX17	breast cancer
XPO4	IgA glomerulonephritis
SFSWAP	human immunodeficiency virus infectious disease
KIAA0754	IgA glomerulonephritis
NFKBIZ	breast cancer
SPINK9	prostate cancer
TRA2B	human immunodeficiency virus infectious disease
LIPK	prostate cancer
AZI2	IgA glomerulonephritis
HIF3A	IgA glomerulonephritis
CHST8	IgA glomerulonephritis
PGA3	IgA glomerulonephritis
PGA4	IgA glomerulonephritis
MMP25	prostate cancer
GREM2	prostate cancer
ZMAT3	IgA glomerulonephritis
MPP5	prostate cancer
HHIP	IgA glomerulonephritis
CDH24	prostate cancer
RGS18	IgA glomerulonephritis
GLYCAM1	IgA glomerulonephritis
WBSCR17	IgA glomerulonephritis
KLHL25	IgA glomerulonephritis
WIPF3	IgA glomerulonephritis
MTMR14	IgA glomerulonephritis
ATG3	IgA glomerulonephritis
POLR1E	breast cancer
SUDS3	breast cancer
MRPS25	breast cancer
GCNT6	IgA glomerulonephritis
DEFB131	IgA glomerulonephritis
CLDN25	prostate cancer
SH3BGRL	IgA glomerulonephritis
USP17L4	IgA glomerulonephritis
SH3GL3	IgA glomerulonephritis
MT1HL1	prostate cancer
ALDH8A1	prostate cancer
NDST4	Ehlers-Danlos syndrome progeroid type
GPR135	IgA glomerulonephritis
USP17L3	IgA glomerulonephritis
PABPC1L2B	stomach cancer
PLA2G2F	IgA glomerulonephritis
SHB	IgA glomerulonephritis
SHC1	IgA glomerulonephritis
DGAT2L7P	IgA glomerulonephritis
FABP9	prostate cancer
FABP12	prostate cancer
URAD	IgA glomerulonephritis
LYPD8	IgA glomerulonephritis
FBXW4	IgA glomerulonephritis
ANAPC1	IgA glomerulonephritis
GORASP1	IgA glomerulonephritis
COPS7B	IgA glomerulonephritis
PDIA2	prostate cancer
UNKL	IgA glomerulonephritis
SMAP2	IgA glomerulonephritis
ACBD3	IgA glomerulonephritis
PLPPR2	IgA glomerulonephritis
SMURF2	IgA glomerulonephritis
SMYD3	breast cancer
MARC1	prostate cancer
SI	IgA glomerulonephritis
GAREM1	IgA glomerulonephritis
CREB3L2	IgA glomerulonephritis
IPPK	inflammatory bowel disease
MEAF6	breast cancer
SIAH1	IgA glomerulonephritis
ENGASE	IgA glomerulonephritis
CERK	IgA glomerulonephritis
AEN	IgA glomerulonephritis
GINS3	IgA glomerulonephritis
TBC1D15	IgA glomerulonephritis
IFT22	Bardet-Biedl syndrome
EFCAB6	prostate cancer
ARV1	porokeratosis
IL25	IgA glomerulonephritis
ST3GAL1	IgA glomerulonephritis
ST3GAL2	IgA glomerulonephritis
ELOVL1	prostate cancer
KLC2	IgA glomerulonephritis
GNPNAT1	IgA glomerulonephritis
SLC13A3	obesity
ETNPPL	IgA glomerulonephritis
TUT1	IgA glomerulonephritis
USP46	IgA glomerulonephritis
PLEKHG2	IgA glomerulonephritis
PAPOLG	IgA glomerulonephritis
BMP1	prostate cancer
LPIN3	IgA glomerulonephritis
STIL	holoprosencephaly
RASAL3	IgA glomerulonephritis
MRPL14	breast cancer
CENPH	IgA glomerulonephritis
MRPS26	breast cancer
MRPS24	breast cancer
MRPS15	breast cancer
MRPS9	breast cancer
MRPS5	breast cancer
MRPL41	breast cancer
MRPL40	breast cancer
MRPL38	breast cancer
MRPL36	breast cancer
MRPL34	breast cancer
MRPL32	breast cancer
SKP1	IgA glomerulonephritis
MRPL11	breast cancer
MRPL1	breast cancer
SLC26A6	prostate cancer
SLAMF1	IgA glomerulonephritis
ACD	IgA glomerulonephritis
RTN4R	IgA glomerulonephritis
MRPL44	breast cancer
NOL6	dyskeratosis congenita
SLC1A4	prostate cancer
BMP3	breast cancer
SLC1A5	IgA glomerulonephritis
MARCKSL1	IgA glomerulonephritis
UPF3B	human immunodeficiency virus infectious disease
SLC1A6	autistic disorder
UPF3A	Diamond-Blackfan anemia
SLC1A7	autistic disorder
INTS3	IgA glomerulonephritis
SLC3A2	hypertension
NADK	IgA glomerulonephritis
SLC5A1	IgA glomerulonephritis
ZFP69B	breast cancer
ZNF649	breast cancer
PYCRL	prostate cancer
WNK3	hypertension
WNK2	hypertension
SLC5A4	IgA glomerulonephritis
BMP5	breast cancer
OR1D4	IgA glomerulonephritis
PRB2	IgA glomerulonephritis
SLC6A7	prostate cancer
RGPD3	human immunodeficiency virus infectious disease
PHLDB3	IgA glomerulonephritis
SLC6A9	prostate cancer
HIST2H3D	IgA glomerulonephritis
GSTT2B	prostate cancer
SLC6A12	prostate cancer
SLC6A13	autistic disorder
SLC7A2	obesity
ZNF732	breast cancer
SLC8A2	IgA glomerulonephritis
LGALS9C	IgA glomerulonephritis
SLC9A2	IgA glomerulonephritis
SLC9A5	IgA glomerulonephritis
BMP8B	breast cancer
SLC12A4	IgA glomerulonephritis
SLC13A1	prostate cancer
SLC15A1	prostate cancer
SLC16A2	prostate cancer
SLC17A1	IgA glomerulonephritis
SLC18A1	IgA glomerulonephritis
SLC18A3	IgA glomerulonephritis
SLC25A1	IgA glomerulonephritis
SLCO2A1	prostate cancer
SLIT1	IgA glomerulonephritis
SLN	hypertension
SLPI	IgA glomerulonephritis
SMARCA1	prostate cancer
OR2B8P	IgA glomerulonephritis
PLEKHA3	IgA glomerulonephritis
AACS	obesity
ZNF747	breast cancer
DLK2	breast cancer
MRPS34	breast cancer
BMX	IgA glomerulonephritis
CHID1	IgA glomerulonephritis
TRAK2	autistic disorder
SMARCC2	breast cancer
SMARCD1	breast cancer
SMARCD2	breast cancer
SLC2A11	IgA glomerulonephritis
SMARCD3	prostate cancer
POLR3D	Treacher Collins syndrome
SMPD2	IgA glomerulonephritis
SUMO3	IgA glomerulonephritis
SUMO2	IgA glomerulonephritis
SNAPC1	Treacher Collins syndrome
SNAPC2	Treacher Collins syndrome
SNAPC3	Treacher Collins syndrome
BNIP1	IgA glomerulonephritis
SNAPC4	Treacher Collins syndrome
FSCN1	IgA glomerulonephritis
SNRNP70	human immunodeficiency virus infectious disease
SNRPA	human immunodeficiency virus infectious disease
SNRPA1	human immunodeficiency virus infectious disease
SNRPB2	human immunodeficiency virus infectious disease
BNIP2	prostate cancer
SNRPC	human immunodeficiency virus infectious disease
SNRPD1	human immunodeficiency virus infectious disease
SNRPD2	human immunodeficiency virus infectious disease
SNRPE	human immunodeficiency virus infectious disease
SNRPF	human immunodeficiency virus infectious disease
SNRPG	human immunodeficiency virus infectious disease
SNX1	IgA glomerulonephritis
SNTB2	hypertension
SOAT1	porokeratosis
BNIP3L	breast cancer
CAPN15	prostate cancer
SOX1	breast cancer
BOK	prostate cancer
DST	prostate cancer
SP3	IgA glomerulonephritis
SP100	IgA glomerulonephritis
UAP1	IgA glomerulonephritis
SPAM1	pneumoconiosis
BPGM	obesity
SPINT1	prostate cancer
SPP2	IgA glomerulonephritis
SPR	phenylketonuria
SPRR1B	prostate cancer
BPHL	prostate cancer
SPRR2D	prostate cancer
SPRR2E	prostate cancer
SPRR2F	prostate cancer
SPRR2G	prostate cancer
SPRR3	prostate cancer
BPI	IgA glomerulonephritis
SQLE	porokeratosis
SRI	IgA glomerulonephritis
SRM	prostate cancer
SRP9	Diamond-Blackfan anemia
SRP14	prostate cancer
SRP19	Diamond-Blackfan anemia
SRP54	Diamond-Blackfan anemia
SRP72	Diamond-Blackfan anemia
SRPK1	human immunodeficiency virus infectious disease
SRPRA	Diamond-Blackfan anemia
SRY	breast cancer
TRIM21	IgA glomerulonephritis
TROVE2	IgA glomerulonephritis
SSB	Treacher Collins syndrome
SSR3	Diamond-Blackfan anemia
SSR4	Diamond-Blackfan anemia
SSRP1	peripheral nervous system disease
BRDT	medulloblastoma
ST13	IgA glomerulonephritis
STC1	breast cancer
HSPA13	IgA glomerulonephritis
ELOVL4	prostate cancer
STK3	IgA glomerulonephritis
STK4	IgA glomerulonephritis
SULT1A2	prostate cancer
BRS3	IgA glomerulonephritis
STRN	IgA glomerulonephritis
STX3	IgA glomerulonephritis
STX4	IgA glomerulonephritis
STX5	IgA glomerulonephritis
STXBP2	IgA glomerulonephritis
STXBP3	IgA glomerulonephritis
SULT1A3	prostate cancer
SULT1C2	prostate cancer
BSG	IgA glomerulonephritis
SUPT4H1	peripheral nervous system disease
SUPT5H	peripheral nervous system disease
SUPT6H	peripheral nervous system disease
MED22	prostate cancer
SUV39H1	breast cancer
BST2	IgA glomerulonephritis
VAMP1	kidney disease
VAMP2	IgA glomerulonephritis
XCL2	IgA glomerulonephritis
SYN1	autistic disorder
SYN2	autistic disorder
SYT1	autistic disorder
TADA2A	breast cancer
TAF1	peripheral nervous system disease
TAF2	peripheral nervous system disease
TAF4	peripheral nervous system disease
TAF4B	peripheral nervous system disease
TAF5	peripheral nervous system disease
TAF6	peripheral nervous system disease
TAF7	peripheral nervous system disease
TAF10	peripheral nervous system disease
TAF11	peripheral nervous system disease
TAF12	peripheral nervous system disease
TAF13	peripheral nervous system disease
TAL1	breast cancer
TAPBP	IgA glomerulonephritis
TARBP2	IgA glomerulonephritis
CNTN2	prostate cancer
TBCC	IgA glomerulonephritis
TBCD	IgA glomerulonephritis
TBL1X	breast cancer
TBP	peripheral nervous system disease
TBX2	breast cancer
TBX6	breast cancer
TCEA1	peripheral nervous system disease
TCEB2	IgA glomerulonephritis
TCEB3	peripheral nervous system disease
TCF7	breast cancer
ZNF354A	breast cancer
TCF20	prostate cancer
VPS72	breast cancer
BTN1A1	IgA glomerulonephritis
TECTB	IgA glomerulonephritis
TCTE3	Bardet-Biedl syndrome
DYNLT1	IgA glomerulonephritis
TDG	IgA glomerulonephritis
TDGF1P3	holoprosencephaly
TEAD1	IgA glomerulonephritis
TEAD4	IgA glomerulonephritis
TEAD3	IgA glomerulonephritis
TEC	IgA glomerulonephritis
TECTA	IgA glomerulonephritis
TERF1	IgA glomerulonephritis
TESK1	prostate cancer
TFAP4	IgA glomerulonephritis
TFCP2	IgA glomerulonephritis
TFDP1	IgA glomerulonephritis
TFDP2	IgA glomerulonephritis
TFF1	prostate cancer
TFF2	prostate cancer
TGFB1I1	prostate cancer
LEFTY2	breast cancer
TGFBR3	prostate cancer
THBS3	IgA glomerulonephritis
THBS4	IgA glomerulonephritis
TCHH	prostate cancer
THOP1	prostate cancer
THRSP	prostate cancer
KLF10	IgA glomerulonephritis
TIA1	prostate cancer
TIAL1	prostate cancer
TIE1	breast cancer
TJP1	IgA glomerulonephritis
TK1	breast cancer
TK2	breast cancer
TLE1	breast cancer
TLE2	breast cancer
TLL2	prostate cancer
SEC62	prostate cancer
TLR3	IgA glomerulonephritis
NR2E1	breast cancer
TSPAN7	autistic disorder
TSPAN8	breast cancer
TM7SF2	porokeratosis
CLDN5	prostate cancer
CLEC3B	IgA glomerulonephritis
TNNC2	hypertension
TNNI1	hypertension
TNNT1	hypertension
C1QC	IgA glomerulonephritis
TNR	prostate cancer
TOP1	prostate cancer
TOP3A	breast cancer
TP53BP1	IgA glomerulonephritis
TP53BP2	breast cancer
TPTE	IgA glomerulonephritis
TRAF2	IgA glomerulonephritis
TRAF3	IgA glomerulonephritis
TRAF5	IgA glomerulonephritis
C3AR1	IgA glomerulonephritis
TRIP6	IgA glomerulonephritis
C4BPA	IgA glomerulonephritis
TRPC1	IgA glomerulonephritis
HIST2H2AA4	IgA glomerulonephritis
C4BPB	IgA glomerulonephritis
TSG101	IgA glomerulonephritis
TSPYL1	prostate cancer
TSTA3	IgA glomerulonephritis
TTF1	prostate cancer
TUBA4A	IgA glomerulonephritis
TUBA3C	IgA glomerulonephritis
SSX2B	breast cancer
RGPD8	human immunodeficiency virus infectious disease
GXYLT2	IgA glomerulonephritis
GTF2H2C	peripheral nervous system disease
NXF2B	human immunodeficiency virus infectious disease
DEFA1B	IgA glomerulonephritis
USP17L5	IgA glomerulonephritis
GGT2	prostate cancer
OPN1MW2	retinitis pigmentosa
DHRS4L1	prostate cancer
CDK11A	IgA glomerulonephritis
EIF3CL	Diamond-Blackfan anemia
TULP3	IgA glomerulonephritis
ZNF736	breast cancer
TCEB3CL	peripheral nervous system disease
ZNF705D	breast cancer
RPEL1	prostate cancer
TNFRSF4	IgA glomerulonephritis
PLIN4	obesity
TXK	IgA glomerulonephritis
SPDYE6	IgA glomerulonephritis
OR4F29	IgA glomerulonephritis
RGPD2	human immunodeficiency virus infectious disease
TBC1D3	IgA glomerulonephritis
ZNF75CP	breast cancer
C7	IgA glomerulonephritis
ZNF726	breast cancer
ZNF735	breast cancer
GTF2H2C_2	peripheral nervous system disease
UBA52	IgA glomerulonephritis
UBB	IgA glomerulonephritis
UBC	IgA glomerulonephritis
UBA1	IgA glomerulonephritis
UBA7	IgA glomerulonephritis
UBE2A	IgA glomerulonephritis
UBE2B	IgA glomerulonephritis
UBE2D1	IgA glomerulonephritis
UBE2D2	IgA glomerulonephritis
UBE2G2	IgA glomerulonephritis
UBE2I	IgA glomerulonephritis
C8G	IgA glomerulonephritis
UBE2N	IgA glomerulonephritis
UBE2V1	IgA glomerulonephritis
UBE2V2	IgA glomerulonephritis
UBTF	breast cancer
UCHL3	IgA glomerulonephritis
SLC35A2	IgA glomerulonephritis
UGP2	IgA glomerulonephritis
UGT2B4	prostate cancer
UGT8	IgA glomerulonephritis
COL14A1	IgA glomerulonephritis
USP4	IgA glomerulonephritis
VPS51	IgA glomerulonephritis
UQCRB	mitochondrial complex I deficiency
UQCRC1	mitochondrial complex I deficiency
UQCRH	mitochondrial complex I deficiency
USF2	prostate cancer
USP1	IgA glomerulonephritis
UTRN	prostate cancer
UTY	breast cancer
UVRAG	IgA glomerulonephritis
VARS	IgA glomerulonephritis
VASP	IgA glomerulonephritis
VBP1	IgA glomerulonephritis
VDAC3	IgA glomerulonephritis
VIL1	IgA glomerulonephritis
VIPR1	prostate cancer
VPREB1	IgA glomerulonephritis
VRK1	IgA glomerulonephritis
VRK2	IgA glomerulonephritis
VTN	IgA glomerulonephritis
WARS	IgA glomerulonephritis
EIF4H	Diamond-Blackfan anemia
WEE1	IgA glomerulonephritis
DAGLA	IgA glomerulonephritis
WNT6	breast cancer
WNT7A	breast cancer
WNT7B	breast cancer
WNT8B	breast cancer
WNT2B	breast cancer
WNT9A	breast cancer
WNT9B	breast cancer
XPO1	IgA glomerulonephritis
FMNL1	IgA glomerulonephritis
XRCC5	IgA glomerulonephritis
YWHAB	IgA glomerulonephritis
YWHAG	IgA glomerulonephritis
ZFP37	breast cancer
PTTG1IP	IgA glomerulonephritis
ZFX	breast cancer
ZIC1	breast cancer
ZNF2	breast cancer
ZNF3	breast cancer
ZNF711	breast cancer
ZNF10	breast cancer
ZNF12	breast cancer
ZNF14	breast cancer
ZNF708	breast cancer
ZNF17	breast cancer
ZNF18	breast cancer
ZNF19	breast cancer
ZNF20	breast cancer
ZNF23	breast cancer
ZNF26	breast cancer
ZNF28	breast cancer
ZNF33A	breast cancer
ZNF33B	breast cancer
ZKSCAN1	breast cancer
ZNF37A	breast cancer
ZNF41	breast cancer
MZF1	breast cancer
ZNF43	breast cancer
ZNF45	breast cancer
ZNF726P1	breast cancer
ZNF70	breast cancer
ZNF74	breast cancer
ZNF75D	breast cancer
ZNF75A	breast cancer
CA5A	obesity
ZNF79	breast cancer
ZNF221	breast cancer
CA6	obesity
ZNF99	breast cancer
CA7	obesity
CA8	obesity
ZNF222	breast cancer
ZNF124	breast cancer
PSAPL1	IgA glomerulonephritis
ZNF133	breast cancer
ZNF135	breast cancer
ZNF136	breast cancer
ZNF138	breast cancer
ZNF140	breast cancer
ZNF141	breast cancer
ZNF143	Treacher Collins syndrome
PCGF2	IgA glomerulonephritis
TRIM25	IgA glomerulonephritis
CA12	IgA glomerulonephritis
ZNF154	breast cancer
ZNF155	breast cancer
ZNF157	breast cancer
ZNF175	breast cancer
ZNF180	breast cancer
ZNF184	breast cancer
ZNF189	breast cancer
ZKSCAN8	breast cancer
ZNF195	breast cancer
ZNF200	breast cancer
ZNF202	breast cancer
ZNF208	breast cancer
ZNF213	breast cancer
ZNF214	breast cancer
ZNF215	breast cancer
ZNF223	breast cancer
ZNF224	breast cancer
ZNF225	breast cancer
ZNF226	breast cancer
CACNA1E	IgA glomerulonephritis
ZNF227	breast cancer
ZNF112	breast cancer
ZNF230	breast cancer
SLC30A1	IgA glomerulonephritis
CACNA1F	prostate cancer
SLC30A2	IgA glomerulonephritis
SLC30A3	IgA glomerulonephritis
ZP2	pneumoconiosis
MAP3K12	IgA glomerulonephritis
ZYX	IgA glomerulonephritis
LUZP1	IgA glomerulonephritis
DNALI1	mitochondrial complex I deficiency
BSND	hypertension
CACNB1	hypertension
BTG2	breast cancer
MOGS	IgA glomerulonephritis
RNF103	IgA glomerulonephritis
FZD5	breast cancer
CACNG1	IgA glomerulonephritis
BRPF1	breast cancer
MAPKAPK3	IgA glomerulonephritis
SLC25A20	obesity
MRPL57	breast cancer
COLEC11	IgA glomerulonephritis
OTUB2	IgA glomerulonephritis
PCYOX1L	IgA glomerulonephritis
LRFN4	autistic disorder
MIS12	IgA glomerulonephritis
CUEDC2	IgA glomerulonephritis
SLX1B	breast cancer
CENPM	IgA glomerulonephritis
NUP37	IgA glomerulonephritis
ZNF655	IgA glomerulonephritis
ST8SIA4	IgA glomerulonephritis
NABP2	breast cancer
REEP5	IgA glomerulonephritis
NOC4L	dyskeratosis congenita
ALG8	IgA glomerulonephritis
PRRG4	prostate cancer
ATG9A	IgA glomerulonephritis
TMEM109	IgA glomerulonephritis
C2orf49	stomach cancer
DSCC1	IgA glomerulonephritis
DCTPP1	IgA glomerulonephritis
ALG12	IgA glomerulonephritis
ZNF426	breast cancer
TRAPPC6A	IgA glomerulonephritis
METTL22	IgA glomerulonephritis
CHAC1	prostate cancer
ZNF705F	breast cancer
MAPKAP1	IgA glomerulonephritis
DEK	breast cancer
DHX58	IgA glomerulonephritis
CHCHD7	IgA glomerulonephritis
FKRP	IgA glomerulonephritis
MMP28	prostate cancer
FA2H	IgA glomerulonephritis
TNIP2	IgA glomerulonephritis
LILRA6	IgA glomerulonephritis
C1orf35	IgA glomerulonephritis
CENPO	IgA glomerulonephritis
ZNF343	breast cancer
FBXL15	IgA glomerulonephritis
THTPA	prostate cancer
BRCC3	IgA glomerulonephritis
DDX39B	human immunodeficiency virus infectious disease
SLC39A7	IgA glomerulonephritis
THOC6	human immunodeficiency virus infectious disease
HSD17B8	prostate cancer
ZNF557	breast cancer
OR52L2P	IgA glomerulonephritis
OR13A1	endometriosis
OR5H6	endometriosis
OR52E1	IgA glomerulonephritis
OR5H2	endometriosis
OR4K5	endometriosis
OR2H2	endometriosis
OR51G1	IgA glomerulonephritis
OR11H2	IgA glomerulonephritis
OR51B4	endometriosis
OR51B2	IgA glomerulonephritis
OR4C5	IgA glomerulonephritis
BHLHE41	breast cancer
B3GNT4	IgA glomerulonephritis
BCL2L14	breast cancer
NOX5	IgA glomerulonephritis
GLB1L	IgA glomerulonephritis
KREMEN2	breast cancer
LRFN3	autistic disorder
TFEB	breast cancer
HAUS3	IgA glomerulonephritis
OR51J1	IgA glomerulonephritis
OR52N1	endometriosis
OR5AL1	IgA glomerulonephritis
OR10G6	IgA glomerulonephritis
S100G	prostate cancer
OR4F5	endometriosis
OR2A4	IgA glomerulonephritis
OR4K1	endometriosis
OR6J1	IgA glomerulonephritis
SLC52A2	prostate cancer
CHPF	Ehlers-Danlos syndrome progeroid type
CARS2	IgA glomerulonephritis
RNF128	IgA glomerulonephritis
MRPL24	breast cancer
MUL1	IgA glomerulonephritis
SAP130	breast cancer
CEP97	Bardet-Biedl syndrome
TCTN1	Bardet-Biedl syndrome
ADIPOR2	IgA glomerulonephritis
CERS4	IgA glomerulonephritis
VCPKMT	IgA glomerulonephritis
HMBOX1	breast cancer
RNASEH2B	Meier-Gorlin syndrome
SNRNP25	human immunodeficiency virus infectious disease
GALNT14	IgA glomerulonephritis
TNFAIP8L2	IgA glomerulonephritis
EFL1	dyskeratosis congenita
ARSJ	IgA glomerulonephritis
CHMP6	IgA glomerulonephritis
PANK3	obesity
MCPH1	IgA glomerulonephritis
AIMP2	prostate cancer
HECTD3	IgA glomerulonephritis
ARHGAP10	IgA glomerulonephritis
DYNC2H1	IgA glomerulonephritis
ICE2	IgA glomerulonephritis
DHX40	IgA glomerulonephritis
PARP8	breast cancer
NLRX1	IgA glomerulonephritis
FN3KRP	IgA glomerulonephritis
SMC6	IgA glomerulonephritis
GAL3ST4	prostate cancer
QTRT2	stomach cancer
GALNT12	IgA glomerulonephritis
CALCB	prostate cancer
IPO4	IgA glomerulonephritis
PPCS	obesity
VPS37B	IgA glomerulonephritis
WDR59	breast cancer
LIN28A	breast cancer
TBC1D17	IgA glomerulonephritis
ZNF419	breast cancer
ECHDC3	obesity
LMAN1L	IgA glomerulonephritis
MAFK	IgA glomerulonephritis
SLC25A22	IgA glomerulonephritis
SNIP1	IgA glomerulonephritis
ASB13	IgA glomerulonephritis
ZNF750	breast cancer
FZD3	breast cancer
GEMIN7	IgA glomerulonephritis
ELMO3	IgA glomerulonephritis
ZFHX4	breast cancer
ACBD4	IgA glomerulonephritis
MTERF1	Alzheimer's disease
ZNF665	breast cancer
FBXO31	IgA glomerulonephritis
GSDMD	IgA glomerulonephritis
ALG9	IgA glomerulonephritis
UGT2A3	prostate cancer
MMRN2	IgA glomerulonephritis
AGMAT	prostate cancer
NIPAL2	prostate cancer
ZNF552	breast cancer
CATSPERB	pneumoconiosis
CAMKMT	retinitis pigmentosa
NAA40	prostate cancer
KDM8	breast cancer
GEMIN6	human immunodeficiency virus infectious disease
PIP4K2C	IgA glomerulonephritis
NHEJ1	IgA glomerulonephritis
PDZD3	IgA glomerulonephritis
TUBAL3	IgA glomerulonephritis
ZNF669	breast cancer
TREML2	IgA glomerulonephritis
BORA	IgA glomerulonephritis
TCTN2	Bardet-Biedl syndrome
ALG13	IgA glomerulonephritis
CPSF7	human immunodeficiency virus infectious disease
RPAP2	IgA glomerulonephritis
CBLL1	IgA glomerulonephritis
NUDT18	IgA glomerulonephritis
UBA5	IgA glomerulonephritis
ZNF212	breast cancer
HDAC11	breast cancer
LPCAT1	IgA glomerulonephritis
ZNF671	breast cancer
ATP8B4	IgA glomerulonephritis
RPP21	stomach cancer
ZNF613	breast cancer
PRR5L	IgA glomerulonephritis
CYBRD1	IgA glomerulonephritis
NUP85	IgA glomerulonephritis
BTNL8	IgA glomerulonephritis
ACTR5	IgA glomerulonephritis
SETD6	breast cancer
MRM1	stomach cancer
ZNF696	breast cancer
PLPPR3	IgA glomerulonephritis
DENND1C	IgA glomerulonephritis
CEP76	IgA glomerulonephritis
JADE1	breast cancer
DENND2D	IgA glomerulonephritis
ABCA11P	prostate cancer
SCD5	coronary artery disease
ATAT1	breast cancer
WLS	breast cancer
ZNF442	breast cancer
GRHL2	breast cancer
DSN1	IgA glomerulonephritis
FRMD1	IgA glomerulonephritis
ZNF702P	breast cancer
TTC26	Bardet-Biedl syndrome
ELOVL7	obesity
ESRP2	prostate cancer
DOCK5	IgA glomerulonephritis
GLRA3	autistic disorder
RMI1	breast cancer
PHC3	IgA glomerulonephritis
SLC8B1	IgA glomerulonephritis
ZNF556	breast cancer
TRPM3	hypertension
PGAP1	paroxysmal nocturnal hemoglobinuria
LRRTM4	autistic disorder
TUBA4B	prostate cancer
ZFP2	breast cancer
ZNF614	breast cancer
PIF1	breast cancer
ZNF703	breast cancer
SIKE1	IgA glomerulonephritis
THOC7	human immunodeficiency virus infectious disease
UXS1	galactosemia
CENPT	IgA glomerulonephritis
EDC3	stomach cancer
NAA15	IgA glomerulonephritis
MOGAT2	IgA glomerulonephritis
IFT74	Bardet-Biedl syndrome
SPSB1	IgA glomerulonephritis
MYCT1	IgA glomerulonephritis
MUS81	breast cancer
HKDC1	IgA glomerulonephritis
FBXO11	breast cancer
CHD9	prostate cancer
NAA50	prostate cancer
COQ10B	mitochondrial complex I deficiency
ACSF2	obesity
TARS2	IgA glomerulonephritis
RAB11FIP1	IgA glomerulonephritis
ORAI2	IgA glomerulonephritis
RUFY1	IgA glomerulonephritis
FAAP100	IgA glomerulonephritis
PIGZ	paroxysmal nocturnal hemoglobinuria
ELL3	IgA glomerulonephritis
PREX2	IgA glomerulonephritis
EDEM3	prostate cancer
STAM	IgA glomerulonephritis
CDK5RAP3	IgA glomerulonephritis
WDCP	breast cancer
FLAD1	prostate cancer
SPHKAP	IgA glomerulonephritis
PDGFD	IgA glomerulonephritis
TET1	prostate cancer
EPC1	breast cancer
CPEB4	IgA glomerulonephritis
ZKSCAN3	breast cancer
CXXC4	breast cancer
CEP70	IgA glomerulonephritis
WNT10A	breast cancer
ULBP1	IgA glomerulonephritis
DNAJC5	IgA glomerulonephritis
WDR82	IgA glomerulonephritis
PABPC1L	stomach cancer
SLC25A16	prostate cancer
BPIFB2	IgA glomerulonephritis
SEL1L2	prostate cancer
REEP4	IgA glomerulonephritis
COASY	obesity
WDR61	peripheral nervous system disease
TNKS2	IgA glomerulonephritis
PDCD1LG2	IgA glomerulonephritis
CD276	prostate cancer
RASSF7	IgA glomerulonephritis
UBXN6	prostate cancer
ESX1	breast cancer
TTYH3	hypertension
ARHGAP39	IgA glomerulonephritis
PTP4A2	IgA glomerulonephritis
THSD7B	IgA glomerulonephritis
C6orf25	IgA glomerulonephritis
LY6G6C	IgA glomerulonephritis
MFAP5	prostate cancer
STARD5	prostate cancer
CPTP	IgA glomerulonephritis
CYB5B	prostate cancer
ZNF34	breast cancer
USP5	IgA glomerulonephritis
INTS5	IgA glomerulonephritis
CALM3	IgA glomerulonephritis
ZNF436	breast cancer
DDHD1	IgA glomerulonephritis
TAS1R2	autistic disorder
TAS1R1	autistic disorder
GRIP2	autistic disorder
KDM7A	breast cancer
SETD7	breast cancer
FXR1	IgA glomerulonephritis
ILKAP	IgA glomerulonephritis
CALML3	IgA glomerulonephritis
GJA9	hypertension
TUBB1	prostate cancer
ZBP1	IgA glomerulonephritis
KCNH6	autistic disorder
SLC25A32	prostate cancer
OR5AC2	endometriosis
OR11H1	endometriosis
OR4F17	endometriosis
GPR68	IgA glomerulonephritis
OR4K15	endometriosis
TCL1A	IgA glomerulonephritis
OR8J3	endometriosis
OR8J2	IgA glomerulonephritis
OR5G3	IgA glomerulonephritis
AP3B2	IgA glomerulonephritis
OR5AK3P	IgA glomerulonephritis
OR52P1P	IgA glomerulonephritis
ANP32A	IgA glomerulonephritis
OR51G2	endometriosis
OR51E2	endometriosis
CALU	IgA glomerulonephritis
OR4P4	endometriosis
OR4C15	endometriosis
OR4A8	IgA glomerulonephritis
OR4A5	endometriosis
OR4A16	endometriosis
OR4A15	endometriosis
OR10W1	endometriosis
OR2AE1	endometriosis
OR4F16	IgA glomerulonephritis
CAMK4	IgA glomerulonephritis
OR2W6P	IgA glomerulonephritis
OR5AC1	IgA glomerulonephritis
OR6N2	endometriosis
OR6K2	endometriosis
OR2T7	IgA glomerulonephritis
OR2L5	endometriosis
OR2G3	endometriosis
OR2G2	endometriosis
OR2C3	endometriosis
PTDSS2	IgA glomerulonephritis
GPR63	autistic disorder
RND2	prostate cancer
SLC38A1	IgA glomerulonephritis
GDPD5	IgA glomerulonephritis
VWA9	IgA glomerulonephritis
TRIM11	IgA glomerulonephritis
NDEL1	IgA glomerulonephritis
CLPB	prostate cancer
CCDC130	breast cancer
NECTIN4	prostate cancer
COIL	IgA glomerulonephritis
NIPA2	prostate cancer
ACSBG2	obesity
CAB39L	breast cancer
UNC93B1	IgA glomerulonephritis
DEFB126	IgA glomerulonephritis
DIAPH3	IgA glomerulonephritis
MAP1LC3B	IgA glomerulonephritis
LOC81691	dyskeratosis congenita
AMN	prostate cancer
OR2B2	endometriosis
SLC14A2	hypertension
PPP1R14C	prostate cancer
SF3A2	human immunodeficiency virus infectious disease
ADAMTS12	IgA glomerulonephritis
TLR10	IgA glomerulonephritis
OR12D3	endometriosis
CAMK2G	IgA glomerulonephritis
NETO1	autistic disorder
VANGL1	breast cancer
TRIM56	IgA glomerulonephritis
SBF2	IgA glomerulonephritis
SFXN3	prostate cancer
ZNF611	breast cancer
ARPC5L	IgA glomerulonephritis
HYI	glycine encephalopathy
FAHD1	prostate cancer
SLC25A28	Friedreich ataxia
CAMLG	IgA glomerulonephritis
SEH1L	IgA glomerulonephritis
CAMP	IgA glomerulonephritis
CLTCL1	IgA glomerulonephritis
PUDP	breast cancer
PNPLA4	prostate cancer
USP11	IgA glomerulonephritis
USP9X	IgA glomerulonephritis
CAPN3	prostate cancer
NAA10	prostate cancer
F8A1	hypertension
CAPN6	prostate cancer
LAGE3	stomach cancer
TKTL1	IgA glomerulonephritis
KDM5D	breast cancer
EPX	IgA glomerulonephritis
DYSF	prostate cancer
HIST1H4I	IgA glomerulonephritis
ACOX2	prostate cancer
ACOX3	prostate cancer
AXIN1	breast cancer
CDC7	IgA glomerulonephritis
CDC45	Meier-Gorlin syndrome
CAPZB	IgA glomerulonephritis
FZD1	breast cancer
FZD7	breast cancer
FZD8	breast cancer
FZD9	breast cancer
HIST1H2AI	IgA glomerulonephritis
CARS	IgA glomerulonephritis
HIST1H2AK	IgA glomerulonephritis
HIST1H2AC	IgA glomerulonephritis
HIST1H2AB	IgA glomerulonephritis
HIST1H2AM	IgA glomerulonephritis
HIST2H2AA3	IgA glomerulonephritis
HIST2H2AC	IgA glomerulonephritis
PITPNM3	IgA glomerulonephritis
HIST1H2BL	IgA glomerulonephritis
ELOVL3	prostate cancer
HIST1H2BN	IgA glomerulonephritis
HIST1H2BF	IgA glomerulonephritis
HIST1H2BE	IgA glomerulonephritis
ADPGK	IgA glomerulonephritis
SH3BGRL3	IgA glomerulonephritis
SF3B5	human immunodeficiency virus infectious disease
INO80B	IgA glomerulonephritis
SLC25A31	IgA glomerulonephritis
HIST1H2BH	IgA glomerulonephritis
ABHD11	IgA glomerulonephritis
RAB33B	IgA glomerulonephritis
HIST1H2BI	IgA glomerulonephritis
APH1B	breast cancer
DOHH	IgA glomerulonephritis
ARHGAP24	IgA glomerulonephritis
HIST1H2BO	IgA glomerulonephritis
PUS3	stomach cancer
EPPK1	IgA glomerulonephritis
HIST2H2BE	IgA glomerulonephritis
HIST1H3A	IgA glomerulonephritis
HIST1H3D	IgA glomerulonephritis
HIST1H3C	IgA glomerulonephritis
HIST1H3E	IgA glomerulonephritis
HIST1H3I	IgA glomerulonephritis
NUF2	IgA glomerulonephritis
RILP	IgA glomerulonephritis
COG3	IgA glomerulonephritis
UCK1	breast cancer
HIST1H3G	IgA glomerulonephritis
TAAR8	IgA glomerulonephritis
HIST1H3J	IgA glomerulonephritis
HIST1H3H	IgA glomerulonephritis
HIST1H4A	IgA glomerulonephritis
NUDT12	IgA glomerulonephritis
SOX7	breast cancer
BCL2L12	prostate cancer
CCM2	IgA glomerulonephritis
HIST1H4F	IgA glomerulonephritis
HIST1H4K	IgA glomerulonephritis
HIST1H4J	IgA glomerulonephritis
ZMIZ2	prostate cancer
TEX101	IgA glomerulonephritis
HIST1H4C	IgA glomerulonephritis
DYNLRB2	Bardet-Biedl syndrome
DYNLRB1	breast cancer
HIST1H4B	IgA glomerulonephritis
SESN2	breast cancer
HIST1H4E	IgA glomerulonephritis
HIST1H4L	IgA glomerulonephritis
HIST1H4G	IgA glomerulonephritis
CD99L2	IgA glomerulonephritis
HSDL1	IgA glomerulonephritis
RHNO1	IgA glomerulonephritis
TRAPPC9	IgA glomerulonephritis
SLC4A9	IgA glomerulonephritis
CASP4	IgA glomerulonephritis
HIST2H4A	IgA glomerulonephritis
JAM3	IgA glomerulonephritis
TRPT1	microcephaly
HYAL3	IgA glomerulonephritis
RIOK1	dyskeratosis congenita
SLC25A18	IgA glomerulonephritis
ATG10	IgA glomerulonephritis
H2AFB3	IgA glomerulonephritis
TFAP2D	breast cancer
ZNF484	breast cancer
LONP2	IgA glomerulonephritis
RBP5	stomach cancer
CASP5	IgA glomerulonephritis
NME5	IgA glomerulonephritis
OR1A1	endometriosis
ESYT3	IgA glomerulonephritis
SETDB2	breast cancer
ATAD3B	IgA glomerulonephritis
OR1D5	endometriosis
TAF3	peripheral nervous system disease
OR1E1	IgA glomerulonephritis
RAB34	IgA glomerulonephritis
GPR61	IgA glomerulonephritis
TBC1D10A	IgA glomerulonephritis
BCO2	prostate cancer
CDCA7	IgA glomerulonephritis
OR1E2	endometriosis
MIXL1	breast cancer
SLC25A2	obesity
FGFBP2	breast cancer
OR1E3	IgA glomerulonephritis
CASP6	IgA glomerulonephritis
OR1P1	IgA glomerulonephritis
OR3A3	IgA glomerulonephritis
STARD3NL	prostate cancer
HDAC10	breast cancer
RASSF4	IgA glomerulonephritis
PIP5K1A	IgA glomerulonephritis
PIP5K1B	IgA glomerulonephritis
FCAMR	IgA glomerulonephritis
PIP4K2B	IgA glomerulonephritis
NCALD	autistic disorder
PLA2G10	IgA glomerulonephritis
KREMEN1	breast cancer
TMPRSS13	IgA glomerulonephritis
B3GNT5	IgA glomerulonephritis
SLC25A11	obesity
OBSCN	IgA glomerulonephritis
ADGRV1	IgA glomerulonephritis
MAGT1	IgA glomerulonephritis
DTNBP1	IgA glomerulonephritis
KIRREL2	prostate cancer
PLEKHN1	IgA glomerulonephritis
TKTL2	IgA glomerulonephritis
KBTBD7	IgA glomerulonephritis
ULK1	IgA glomerulonephritis
FBXO30	IgA glomerulonephritis
USP44	IgA glomerulonephritis
SLC41A2	IgA glomerulonephritis
PCBD2	phenylketonuria
PRAM1	breast cancer
PCGF6	breast cancer
QRFPR	IgA glomerulonephritis
EEA1	IgA glomerulonephritis
ZNF394	breast cancer
ATRIP	IgA glomerulonephritis
WDR75	dyskeratosis congenita
ACAD11	obesity
CEP78	IgA glomerulonephritis
USP42	IgA glomerulonephritis
TOMM40L	IgA glomerulonephritis
UTP15	stomach cancer
SYDE2	IgA glomerulonephritis
KAT8	breast cancer
PPP1R1B	IgA glomerulonephritis
RNASEH2C	Meier-Gorlin syndrome
ASCC2	IgA glomerulonephritis
NLRC5	IgA glomerulonephritis
ANTXR1	IgA glomerulonephritis
STX7	IgA glomerulonephritis
POLR1B	breast cancer
SLA2	IgA glomerulonephritis
ZCCHC7	stomach cancer
FAR1	IgA glomerulonephritis
SLITRK6	IgA glomerulonephritis
FAM96A	IgA glomerulonephritis
SETD3	breast cancer
POMK	IgA glomerulonephritis
TBC1D3F	IgA glomerulonephritis
WDR24	breast cancer
RGPD5	human immunodeficiency virus infectious disease
TRAF7	IgA glomerulonephritis
TMEM126A	prostate cancer
ATP13A4	autistic disorder
BBOX1	prostate cancer
MRI1	prostate cancer
MED10	breast cancer
FYTTD1	human immunodeficiency virus infectious disease
PSD2	IgA glomerulonephritis
SGIP1	IgA glomerulonephritis
HAGHL	obesity
POLR3GL	Treacher Collins syndrome
CHCHD5	IgA glomerulonephritis
ZNF282	breast cancer
POLDIP3	human immunodeficiency virus infectious disease
COQ5	multiple system atrophy
STK24	IgA glomerulonephritis
NTPCR	IgA glomerulonephritis
ING5	breast cancer
CAPNS2	IgA glomerulonephritis
WDR83	IgA glomerulonephritis
GINS4	IgA glomerulonephritis
PYM1	human immunodeficiency virus infectious disease
NUDT16L1	IgA glomerulonephritis
MRPL45	breast cancer
VPS25	IgA glomerulonephritis
NAA38	IgA glomerulonephritis
ACBD6	prostate cancer
THOC3	human immunodeficiency virus infectious disease
SARNP	human immunodeficiency virus infectious disease
HVCN1	pneumoconiosis
PCGF5	breast cancer
AKT1S1	IgA glomerulonephritis
GFM2	breast cancer
COG8	IgA glomerulonephritis
SOAT2	prostate cancer
SDPR	prostate cancer
NSMAF	IgA glomerulonephritis
CASQ1	hypertension
CYSTM1	IgA glomerulonephritis
GNPAT	IgA glomerulonephritis
PROK1	IgA glomerulonephritis
ZNF528	breast cancer
DYRK3	IgA glomerulonephritis
RAB11FIP4	IgA glomerulonephritis
FRMPD3	IgA glomerulonephritis
DOT1L	breast cancer
BRSK1	breast cancer
SYVN1	IgA glomerulonephritis
ABLIM2	IgA glomerulonephritis
ZNF333	breast cancer
MLK4	IgA glomerulonephritis
EFCAB7	IgA glomerulonephritis
FBN3	prostate cancer
DHX16	human immunodeficiency virus infectious disease
FAM120B	prostate cancer
CASQ2	hypertension
SPIRE2	breast cancer
PLPP5	IgA glomerulonephritis
GHDC	IgA glomerulonephritis
MCM8	Meier-Gorlin syndrome
DCTN5	IgA glomerulonephritis
ZC3H8	IgA glomerulonephritis
HOPX	human immunodeficiency virus infectious disease
ACSS1	obesity
MCHR2	IgA glomerulonephritis
KBTBD8	IgA glomerulonephritis
MRPL43	breast cancer
PARD6G	prostate cancer
MAP1LC3A	IgA glomerulonephritis
COL25A1	prostate cancer
GNPTG	IgA glomerulonephritis
TTF2	prostate cancer
PARD6B	prostate cancer
TUBB6	IgA glomerulonephritis
NT5C1A	IgA glomerulonephritis
KLF11	IgA glomerulonephritis
ST6GAL2	IgA glomerulonephritis
KIRREL3	prostate cancer
KRBA1	breast cancer
AFAP1L2	IgA glomerulonephritis
GPR174	autistic disorder
IL1F10	IgA glomerulonephritis
SUPT3H	breast cancer
USP38	breast cancer
KIF2B	IgA glomerulonephritis
PLA2G12B	prostate cancer
DGAT2	IgA glomerulonephritis
ADGRE3	IgA glomerulonephritis
RNASE7	IgA glomerulonephritis
DPY30	breast cancer
RETNLB	IgA glomerulonephritis
HES7	breast cancer
SMARCA5	breast cancer
ZNF347	breast cancer
CARD6	IgA glomerulonephritis
KDM2B	breast cancer
SLC9A7	IgA glomerulonephritis
MCEE	maple syrup urine disease
GJA10	hypertension
LOXL3	IgA glomerulonephritis
COX4I2	mitochondrial complex I deficiency
GTPBP3	IgA glomerulonephritis
GPT2	prostate cancer
LNX1	IgA glomerulonephritis
IRS4	IgA glomerulonephritis
PIGO	breast cancer
PLEKHA8	IgA glomerulonephritis
SPSB2	IgA glomerulonephritis
OGT	IgA glomerulonephritis
CBX2	IgA glomerulonephritis
CNDP1	autistic disorder
UNC119B	Bardet-Biedl syndrome
USP30	IgA glomerulonephritis
PCGF1	breast cancer
CDC42BPA	IgA glomerulonephritis
ZNF577	breast cancer
CRACR2A	IgA glomerulonephritis
ZNF607	breast cancer
KMT5C	breast cancer
HIRIP3	IgA glomerulonephritis
RAE1	IgA glomerulonephritis
GPAT3	IgA glomerulonephritis
PLCD4	IgA glomerulonephritis
SEMA7A	prostate cancer
LMNB2	IgA glomerulonephritis
CILP	IgA glomerulonephritis
ABHD14B	prostate cancer
ZNF496	breast cancer
GALR3	IgA glomerulonephritis
PHF5A	human immunodeficiency virus infectious disease
KLHL22	IgA glomerulonephritis
PTPN5	IgA glomerulonephritis
HAVCR2	IgA glomerulonephritis
CBR4	prostate cancer
ZNF514	breast cancer
AIFM2	breast cancer
SLC7A3	prostate cancer
ADO	prostate cancer
ZSCAN10	prostate cancer
POMGNT2	IgA glomerulonephritis
ATAD1	breast cancer
CEP89	Bardet-Biedl syndrome
ARHGEF39	IgA glomerulonephritis
MAP4K3	IgA glomerulonephritis
ZNF382	breast cancer
SLC35B4	IgA glomerulonephritis
ZNF587	breast cancer
UTP4	dyskeratosis congenita
ALG10	IgA glomerulonephritis
ZNF566	breast cancer
MASTL	IgA glomerulonephritis
RAB2B	IgA glomerulonephritis
ZNRF1	IgA glomerulonephritis
ATG4C	IgA glomerulonephritis
MAEL	prostate cancer
PRPF38A	human immunodeficiency virus infectious disease
TNS4	prostate cancer
RELT	IgA glomerulonephritis
SYTL1	IgA glomerulonephritis
UBASH3B	IgA glomerulonephritis
LSM10	human immunodeficiency virus infectious disease
PPFIA4	autistic disorder
ATG4D	IgA glomerulonephritis
DISP1	holoprosencephaly
RANBP3	breast cancer
ARHGAP19	IgA glomerulonephritis
PPFIA2	autistic disorder
PIGY	paroxysmal nocturnal hemoglobinuria
PPFIA1	autistic disorder
PHYKPL	prostate cancer
SLC43A1	IgA glomerulonephritis
USP45	IgA glomerulonephritis
PKP4	prostate cancer
REPS1	IgA glomerulonephritis
PIK3R3	IgA glomerulonephritis
PARG	IgA glomerulonephritis
CNTNAP1	prostate cancer
ENC1	prostate cancer
NDST2	Ehlers-Danlos syndrome progeroid type
MMP23B	prostate cancer
LIPF	IgA glomerulonephritis
ITGA10	IgA glomerulonephritis
IFITM1	IgA glomerulonephritis
HAT1	breast cancer
HIST1H2AH	IgA glomerulonephritis
DGKE	IgA glomerulonephritis
DGKD	IgA glomerulonephritis
DDO	prostate cancer
KRTAP4-1	prostate cancer
CYP4F2	prostate cancer
FBF1	Bardet-Biedl syndrome
YBX3	prostate cancer
ABCC11	prostate cancer
COPS3	IgA glomerulonephritis
CHST1	IgA glomerulonephritis
CBX4	IgA glomerulonephritis
CAMK1	IgA glomerulonephritis
SYDE1	IgA glomerulonephritis
ALG2	IgA glomerulonephritis
BARX2	prostate cancer
RGS8	breast cancer
EAF1	peripheral nervous system disease
DNAJC14	human immunodeficiency virus infectious disease
NKD1	breast cancer
NKD2	breast cancer
PPFIA3	autistic disorder
SLC22A16	prostate cancer
SLC45A3	IgA glomerulonephritis
ZIC5	breast cancer
APOL1	IgA glomerulonephritis
LMO4	prostate cancer
ZCRB1	human immunodeficiency virus infectious disease
STON2	IgA glomerulonephritis
DOCK7	IgA glomerulonephritis
HELZ2	prostate cancer
DISP2	IgA glomerulonephritis
TNKS1BP1	breast cancer
AP3B1	IgA glomerulonephritis
TANC1	autistic disorder
SSH2	IgA glomerulonephritis
SELENOI	IgA glomerulonephritis
GFM1	breast cancer
SCIN	IgA glomerulonephritis
DNAJC5B	prostate cancer
BLZF1	IgA glomerulonephritis
MAPKAPK5	IgA glomerulonephritis
CDC14B	IgA glomerulonephritis
CDC14A	IgA glomerulonephritis
TCAP	prostate cancer
PRPF18	human immunodeficiency virus infectious disease
THOC5	human immunodeficiency virus infectious disease
YARS	tyrosinemia
MADD	IgA glomerulonephritis
AKR7A2	prostate cancer
SCARF1	IgA glomerulonephritis
LY6D	IgA glomerulonephritis
OR6A2	endometriosis
ACTL6A	IgA glomerulonephritis
RGS20	IgA glomerulonephritis
NOP14	dyskeratosis congenita
PLA2G4C	IgA glomerulonephritis
RUVBL1	IgA glomerulonephritis
RDH16	prostate cancer
KLF7	prostate cancer
PLPP2	IgA glomerulonephritis
NPFF	IgA glomerulonephritis
CDK13	IgA glomerulonephritis
RFXANK	IgA glomerulonephritis
CBFA2T3	IgA glomerulonephritis
HSD17B6	prostate cancer
DNAH17	mitochondrial complex I deficiency
SSNA1	IgA glomerulonephritis
EIF4EBP3	human immunodeficiency virus infectious disease
CHRD	breast cancer
LAMTOR3	IgA glomerulonephritis
DDX3Y	IgA glomerulonephritis
PDE5A	IgA glomerulonephritis
TNKS	breast cancer
ALDH4A1	amino acid metabolic disorder
SERPINA6	breast cancer
EIF3C	Diamond-Blackfan anemia
EIF3D	Diamond-Blackfan anemia
EIF3F	Diamond-Blackfan anemia
EIF3G	Diamond-Blackfan anemia
EIF3I	Diamond-Blackfan anemia
EIF3J	Diamond-Blackfan anemia
EIF4G3	breast cancer
VAMP4	IgA glomerulonephritis
STX11	IgA glomerulonephritis
STX10	IgA glomerulonephritis
PEA15	IgA glomerulonephritis
MARCO	IgA glomerulonephritis
KRT38	prostate cancer
KRT37	prostate cancer
KRT36	prostate cancer
HYAL2	IgA glomerulonephritis
GALNT4	IgA glomerulonephritis
DGAT1	prostate cancer
CDC23	IgA glomerulonephritis
S1PR4	IgA glomerulonephritis
ACTN1	prostate cancer
B4GALT3	IgA glomerulonephritis
B4GALT2	IgA glomerulonephritis
B3GALT4	IgA glomerulonephritis
B3GALNT1	IgA glomerulonephritis
B3GALT2	IgA glomerulonephritis
B3GALT1	IgA glomerulonephritis
TNK1	IgA glomerulonephritis
TRADD	IgA glomerulonephritis
PNPT1	IgA glomerulonephritis
TNFRSF25	IgA glomerulonephritis
SNX4	IgA glomerulonephritis
SNX3	IgA glomerulonephritis
CTNNAL1	IgA glomerulonephritis
ADAM19	breast cancer
GBF1	IgA glomerulonephritis
RNMT	peripheral nervous system disease
RNGTT	peripheral nervous system disease
GPAA1	paroxysmal nocturnal hemoglobinuria
MYH13	prostate cancer
MYOM1	prostate cancer
RIPK1	IgA glomerulonephritis
HRK	prostate cancer
ADAM23	autistic disorder
ADAM21	pneumoconiosis
ADAM20	pneumoconiosis
ADAM15	prostate cancer
CDS2	IgA glomerulonephritis
CD164	IgA glomerulonephritis
RAB11A	IgA glomerulonephritis
TNFRSF6B	breast cancer
NAPG	IgA glomerulonephritis
NAPA	IgA glomerulonephritis
MTMR1	IgA glomerulonephritis
MPDZ	prostate cancer
RIOK3	IgA glomerulonephritis
MATN4	prostate cancer
RGS11	IgA glomerulonephritis
DLK1	breast cancer
FBP2	IgA glomerulonephritis
TNFRSF10D	breast cancer
TNFRSF10C	breast cancer
DYRK4	IgA glomerulonephritis
PEX11A	prostate cancer
IL1RL2	IgA glomerulonephritis
GALR2	IgA glomerulonephritis
CCNK	peripheral nervous system disease
DPM1	IgA glomerulonephritis
BANF1	IgA glomerulonephritis
DPM2	IgA glomerulonephritis
SAP30	breast cancer
CES2	prostate cancer
LIN7A	autistic disorder
CD84	IgA glomerulonephritis
KSR1	IgA glomerulonephritis
TSC22D1	breast cancer
KAT2B	breast cancer
AKAP4	IgA glomerulonephritis
ASAP2	IgA glomerulonephritis
PROZ	IgA glomerulonephritis
CCKAR	IgA glomerulonephritis
LDB1	breast cancer
APLN	IgA glomerulonephritis
ARHGEF7	IgA glomerulonephritis
RRP36	dyskeratosis congenita
SGPL1	IgA glomerulonephritis
CDC16	IgA glomerulonephritis
NAE1	IgA glomerulonephritis
SLC5A6	prostate cancer
DDX18	IgA glomerulonephritis
KRIT1	breast cancer
EIF2B3	Diamond-Blackfan anemia
EIF2B2	Diamond-Blackfan anemia
BUD31	human immunodeficiency virus infectious disease
MTMR2	IgA glomerulonephritis
PRPF4B	IgA glomerulonephritis
ACTN3	prostate cancer
CPNE1	IgA glomerulonephritis
AP1S2	IgA glomerulonephritis
AP1G2	IgA glomerulonephritis
AP1M1	IgA glomerulonephritis
GYG2	IgA glomerulonephritis
CACNA1I	prostate cancer
TRIM4	IgA glomerulonephritis
HERC1	IgA glomerulonephritis
SNURF	human immunodeficiency virus infectious disease
RAB29	IgA glomerulonephritis
WASF1	IgA glomerulonephritis
BAIAP3	breast cancer
TOP3B	breast cancer
CDK5R2	IgA glomerulonephritis
AP3D1	IgA glomerulonephritis
BTRC	IgA glomerulonephritis
CCND3	IgA glomerulonephritis
HIST1H3F	IgA glomerulonephritis
HIST1H2AG	IgA glomerulonephritis
HIST1H2BJ	IgA glomerulonephritis
H1FX	acute myeloid leukemia
MGAM	IgA glomerulonephritis
CHRNA6	autistic disorder
P4HA2	IgA glomerulonephritis
SERPINB12	IgA glomerulonephritis
WNT3A	breast cancer
HPS4	IgA glomerulonephritis
SIGLEC10	IgA glomerulonephritis
GAL3ST3	prostate cancer
PPP1R3F	IgA glomerulonephritis
ARHGAP11B	IgA glomerulonephritis
ABCC10	prostate cancer
FGD3	IgA glomerulonephritis
ATG16L2	IgA glomerulonephritis
PLOD3	IgA glomerulonephritis
SIGLEC12	IgA glomerulonephritis
SEC16B	IgA glomerulonephritis
PLCZ1	IgA glomerulonephritis
STBD1	IgA glomerulonephritis
AQP10	obesity
SLC25A21	prostate cancer
KBTBD6	IgA glomerulonephritis
WDR34	Bardet-Biedl syndrome
CCNF	IgA glomerulonephritis
UBE3B	IgA glomerulonephritis
ATP6V0E1	IgA glomerulonephritis
PGLYRP1	IgA glomerulonephritis
LIMD1	IgA glomerulonephritis
RHOT2	IgA glomerulonephritis
TNFSF18	IgA glomerulonephritis
KLC4	IgA glomerulonephritis
KALRN	IgA glomerulonephritis
DPH6	IgA glomerulonephritis
HAP1	autistic disorder
SYT8	IgA glomerulonephritis
UBE3D	IgA glomerulonephritis
ZNF30	breast cancer
CCNG2	IgA glomerulonephritis
PHLDB2	IgA glomerulonephritis
BTBD6	IgA glomerulonephritis
TAF1B	breast cancer
TAF1A	breast cancer
SLC25A14	obesity
HS6ST2	Ehlers-Danlos syndrome progeroid type
SYS1	IgA glomerulonephritis
CCNH	IgA glomerulonephritis
MAP3K14	IgA glomerulonephritis
CH25H	prostate cancer
ZNF551	breast cancer
BRSK2	breast cancer
UNC5A	prostate cancer
HIP1R	IgA glomerulonephritis
OTULIN	IgA glomerulonephritis
NAT8	prostate cancer
RHBDL1	human immunodeficiency virus infectious disease
KLHL13	IgA glomerulonephritis
ZNF616	breast cancer
PKD2L1	autistic disorder
ZNF468	breast cancer
CTU1	stomach cancer
TAAR5	IgA glomerulonephritis
UBA3	IgA glomerulonephritis
CCNT1	peripheral nervous system disease
UBE2M	IgA glomerulonephritis
IFT20	Bardet-Biedl syndrome
MCFD2	IgA glomerulonephritis
ATP6V1E2	IgA glomerulonephritis
SPAG9	prostate cancer
ZNF622	IgA glomerulonephritis
ERI1	disease of mental health
SH2D2A	IgA glomerulonephritis
GADD45GIP1	breast cancer
CCNT2	peripheral nervous system disease
PSTPIP1	IgA glomerulonephritis
YIF1B	IgA glomerulonephritis
SHF	IgA glomerulonephritis
NFS1	xanthinuria
MCU	IgA glomerulonephritis
SLC7A6	hypertension
ZNF799	breast cancer
SLC13A2	obesity
ZNF625	breast cancer
ZNF700	breast cancer
ZNF439	breast cancer
PAPSS2	prostate cancer
PAPSS1	prostate cancer
PIAS2	IgA glomerulonephritis
COX19	IgA glomerulonephritis
MAP3K6	IgA glomerulonephritis
ZNF486	breast cancer
SYT7	autistic disorder
TBL1Y	breast cancer
PPP1R3E	IgA glomerulonephritis
ANGPTL1	breast cancer
CLDN12	prostate cancer
ASH2L	breast cancer
SEC11C	obesity
CLDN10	prostate cancer
CLDN6	prostate cancer
PYGO2	breast cancer
LDB2	breast cancer
CCT6A	prostate cancer
TMEM55B	IgA glomerulonephritis
ZNF479	breast cancer
EIF1AY	human immunodeficiency virus infectious disease
TMSB4Y	IgA glomerulonephritis
ZNF697	breast cancer
CD1A	IgA glomerulonephritis
PIGQ	breast cancer
SART1	human immunodeficiency virus infectious disease
DNAJA3	IgA glomerulonephritis
TRIM41	IgA glomerulonephritis
TBX19	prostate cancer
ESAM	IgA glomerulonephritis
DHX57	IgA glomerulonephritis
USP14	IgA glomerulonephritis
USP6	prostate cancer
USP2	IgA glomerulonephritis
KIFC2	IgA glomerulonephritis
CREB3L1	IgA glomerulonephritis
CD1B	IgA glomerulonephritis
USP10	IgA glomerulonephritis
FMNL3	IgA glomerulonephritis
CERS5	IgA glomerulonephritis
MTMR6	IgA glomerulonephritis
CD1C	IgA glomerulonephritis
MTMR4	IgA glomerulonephritis
NMI	IgA glomerulonephritis
ZNF682	breast cancer
ATP6V0D1	IgA glomerulonephritis
SEC22C	IgA glomerulonephritis
NUP210L	IgA glomerulonephritis
KRT75	prostate cancer
GGTLC2	prostate cancer
SLC16A3	IgA glomerulonephritis
PDLIM1	IgA glomerulonephritis
CNOT9	stomach cancer
LMF2	prostate cancer
CD1E	IgA glomerulonephritis
DERL3	IgA glomerulonephritis
KCNQ4	autistic disorder
UAP1L1	IgA glomerulonephritis
ARHGEF1	IgA glomerulonephritis
ATG12	IgA glomerulonephritis
FAAP24	IgA glomerulonephritis
RNF185	IgA glomerulonephritis
ACBD5	IgA glomerulonephritis
HGS	IgA glomerulonephritis
NEURL1	breast cancer
CTDP1	peripheral nervous system disease
COL23A1	IgA glomerulonephritis
SLC28A2	IgA glomerulonephritis
RPS19BP1	IgA glomerulonephritis
PLXNA4	prostate cancer
ZNF830	IgA glomerulonephritis
DEPDC7	IgA glomerulonephritis
TDRD12	prostate cancer
BOC	IgA glomerulonephritis
EBAG9	prostate cancer
COX7A2L	mitochondrial complex I deficiency
SYT12	autistic disorder
CENPL	IgA glomerulonephritis
SCAF11	IgA glomerulonephritis
LONRF1	IgA glomerulonephritis
LPAR2	IgA glomerulonephritis
ACY3	prostate cancer
IDI2	porokeratosis
MFSD4B	IgA glomerulonephritis
MAP3K13	IgA glomerulonephritis
LIN52	IgA glomerulonephritis
NEK9	IgA glomerulonephritis
CHMP7	IgA glomerulonephritis
AP4M1	IgA glomerulonephritis
ALKBH8	stomach cancer
MYLK3	IgA glomerulonephritis
WDR20	IgA glomerulonephritis
BUB3	IgA glomerulonephritis
CALML4	IgA glomerulonephritis
RFT1	IgA glomerulonephritis
SLC24A1	retinitis pigmentosa
TTC5	breast cancer
DDX21	breast cancer
C11orf52	IgA glomerulonephritis
DEDD	IgA glomerulonephritis
COG7	IgA glomerulonephritis
KCNAB3	prostate cancer
SLC33A1	IgA glomerulonephritis
ACVR2A	breast cancer
LRRFIP1	IgA glomerulonephritis
TTC30A	Bardet-Biedl syndrome
DSEL	IgA glomerulonephritis
VAPA	IgA glomerulonephritis
NOLC1	prostate cancer
MRPS36	breast cancer
ZNF461	breast cancer
ZNF585B	breast cancer
DLGAP1	autistic disorder
CAPN13	prostate cancer
GLYATL1	lung benign neoplasm
CRB3	prostate cancer
MRRF	breast cancer
CD7	IgA glomerulonephritis
GCNT3	IgA glomerulonephritis
GPR50	autistic disorder
DHRS3	retinitis pigmentosa
RPS6KA5	IgA glomerulonephritis
NUMBL	breast cancer
AIMP1	prostate cancer
ATXN3L	IgA glomerulonephritis
TSPOAP1	autistic disorder
G6PC3	IgA glomerulonephritis
ASB16	IgA glomerulonephritis
ZNF764	breast cancer
MOB1B	IgA glomerulonephritis
PDLIM7	IgA glomerulonephritis
TIMM50	IgA glomerulonephritis
MAPKAPK2	IgA glomerulonephritis
TIFA	IgA glomerulonephritis
CYTH3	IgA glomerulonephritis
CYTH2	IgA glomerulonephritis
CYTH1	IgA glomerulonephritis
DPH7	IgA glomerulonephritis
SLC38A5	IgA glomerulonephritis
BPIFB1	IgA glomerulonephritis
COPB2	IgA glomerulonephritis
HIST3H2A	IgA glomerulonephritis
GPR37L1	IgA glomerulonephritis
REEP6	IgA glomerulonephritis
IMP4	dyskeratosis congenita
TAAR2	IgA glomerulonephritis
TAAR3	IgA glomerulonephritis
ADGRG1	IgA glomerulonephritis
GPR55	IgA glomerulonephritis
UBE2Q2	IgA glomerulonephritis
GPR52	autistic disorder
MARS2	IgA glomerulonephritis
ADAMTSL1	IgA glomerulonephritis
SRSF11	human immunodeficiency virus infectious disease
ATP6V1F	IgA glomerulonephritis
PEX11G	Zellweger syndrome
B3GNT7	IgA glomerulonephritis
NT5C1B	IgA glomerulonephritis
COQ10A	mitochondrial complex I deficiency
SOCS6	IgA glomerulonephritis
ZNF235	breast cancer
NAPRT	IgA glomerulonephritis
KCNG4	autistic disorder
ASIC3	IgA glomerulonephritis
KCNB2	autistic disorder
ORAI3	IgA glomerulonephritis
MMP20	prostate cancer
ZNF561	breast cancer
NREP	breast cancer
PRDM6	breast cancer
PIGM	breast cancer
IGSF8	IgA glomerulonephritis
TRIP13	IgA glomerulonephritis
TRIP12	IgA glomerulonephritis
TRIP11	IgA glomerulonephritis
TRIP10	IgA glomerulonephritis
GTF3C5	Treacher Collins syndrome
GTF3C4	Treacher Collins syndrome
CD22	IgA glomerulonephritis
GTF3C3	Treacher Collins syndrome
HAUS8	IgA glomerulonephritis
B4GALT5	IgA glomerulonephritis
MVB12A	IgA glomerulonephritis
CNOT8	stomach cancer
MMGT1	prostate cancer
GLP2R	IgA glomerulonephritis
MYL10	prostate cancer
VAMP3	IgA glomerulonephritis
EFTUD2	human immunodeficiency virus infectious disease
TAOK2	IgA glomerulonephritis
ZNF670	breast cancer
NDST3	Ehlers-Danlos syndrome progeroid type
RPL23	Diamond-Blackfan anemia
TPTE2	IgA glomerulonephritis
CER1	breast cancer
UBE4A	IgA glomerulonephritis
TRMT10A	stomach cancer
CACNA2D4	prostate cancer
PPIG	prostate cancer
CPNE6	IgA glomerulonephritis
TADA2B	IgA glomerulonephritis
RAB33A	IgA glomerulonephritis
TJAP1	prostate cancer
MYOCD	IgA glomerulonephritis
CAPZA3	IgA glomerulonephritis
ARHGAP18	IgA glomerulonephritis
RAB9A	IgA glomerulonephritis
SLC9A3R1	IgA glomerulonephritis
KIF3B	IgA glomerulonephritis
ZFYVE9	IgA glomerulonephritis
PLAA	prostate cancer
PPT2	prostate cancer
COX5A	mitochondrial complex I deficiency
NRXN2	autistic disorder
COG1	IgA glomerulonephritis
LIPG	IgA glomerulonephritis
SLC22A13	prostate cancer
TGFBRAP1	IgA glomerulonephritis
NMT2	IgA glomerulonephritis
ACTR8	IgA glomerulonephritis
ATPIF1	mitochondrial complex I deficiency
CLEC6A	IgA glomerulonephritis
CD101	IgA glomerulonephritis
PIGS	paroxysmal nocturnal hemoglobinuria
TTYH2	hypertension
GRAP2	IgA glomerulonephritis
POM121L2	human immunodeficiency virus infectious disease
CGB7	breast cancer
SELENOF	prostate cancer
LRRC4B	prostate cancer
FTMT	variegate porphyria
ZNF101	breast cancer
SFXN1	IgA glomerulonephritis
SNRNP40	human immunodeficiency virus infectious disease
ORMDL1	IgA glomerulonephritis
ARHGAP29	IgA glomerulonephritis
MED21	prostate cancer
SYTL3	IgA glomerulonephritis
SYTL4	IgA glomerulonephritis
SYTL5	IgA glomerulonephritis
ARHGAP12	IgA glomerulonephritis
DDX23	human immunodeficiency virus infectious disease
ABCC12	prostate cancer
HAND1	breast cancer
ZNF264	breast cancer
NTN1	prostate cancer
OPN4	IgA glomerulonephritis
FOXQ1	prostate cancer
H2AFV	IgA glomerulonephritis
KCNK6	type 2 diabetes mellitus
NCR2	IgA glomerulonephritis
NCR1	IgA glomerulonephritis
MED23	breast cancer
MED26	breast cancer
MED27	breast cancer
MED7	breast cancer
QKI	IgA glomerulonephritis
MAP4K4	IgA glomerulonephritis
GGPS1	porokeratosis
HOMER2	autistic disorder
HOMER1	autistic disorder
ARHGEF6	IgA glomerulonephritis
SIGLEC6	IgA glomerulonephritis
RASAL2	IgA glomerulonephritis
PICK1	autistic disorder
SH3BP5	IgA glomerulonephritis
PCYT1B	IgA glomerulonephritis
CHST3	Ehlers-Danlos syndrome progeroid type
CD34	IgA glomerulonephritis
AKAP6	IgA glomerulonephritis
ROCK2	IgA glomerulonephritis
NAPSA	IgA glomerulonephritis
MED20	breast cancer
SLC25A27	obesity
STX8	IgA glomerulonephritis
CHST10	IgA glomerulonephritis
PIGL	breast cancer
PIGB	breast cancer
PGS1	IgA glomerulonephritis
PSMF1	human immunodeficiency virus infectious disease
AKAP5	IgA glomerulonephritis
MAGED1	IgA glomerulonephritis
RPH3AL	IgA glomerulonephritis
ADAMTS4	IgA glomerulonephritis
ADAMTS2	IgA glomerulonephritis
PMPCB	IgA glomerulonephritis
FXR2	IgA glomerulonephritis
GAL3ST1	IgA glomerulonephritis
SPTLC2	IgA glomerulonephritis
TBPL1	IgA glomerulonephritis
EEF1E1	prostate cancer
SCAMP1	IgA glomerulonephritis
TECR	obesity
VPS4B	IgA glomerulonephritis
GOSR1	IgA glomerulonephritis
TMEM59	IgA glomerulonephritis
BAG5	IgA glomerulonephritis
ENTPD1	IgA glomerulonephritis
BAG4	IgA glomerulonephritis
BAG2	IgA glomerulonephritis
GMFG	IgA glomerulonephritis
TP53I3	breast cancer
CIR1	breast cancer
NRG2	IgA glomerulonephritis
RAB3D	IgA glomerulonephritis
APBA3	autistic disorder
ATP6V1G1	IgA glomerulonephritis
MRPL33	breast cancer
SEC22B	IgA glomerulonephritis
ENTPD3	IgA glomerulonephritis
H6PD	IgA glomerulonephritis
CEP41	IgA glomerulonephritis
ENTPD5	breast cancer
GOSR2	IgA glomerulonephritis
NR1D1	breast cancer
CLOCK	IgA glomerulonephritis
BRE	IgA glomerulonephritis
SOX13	breast cancer
ENTPD4	IgA glomerulonephritis
RBM39	human immunodeficiency virus infectious disease
KIF20B	IgA glomerulonephritis
CREB5	IgA glomerulonephritis
WTAP	human immunodeficiency virus infectious disease
CYTIP	breast cancer
PITPNM1	IgA glomerulonephritis
PDIA4	prostate cancer
RNF14	IgA glomerulonephritis
RAB36	IgA glomerulonephritis
CD47	IgA glomerulonephritis
GDA	breast cancer
RNF7	IgA glomerulonephritis
TRAF4	IgA glomerulonephritis
CD48	IgA glomerulonephritis
CELSR1	IgA glomerulonephritis
KLK4	IgA glomerulonephritis
GUCA1C	retinitis pigmentosa
SNCAIP	IgA glomerulonephritis
RGS6	IgA glomerulonephritis
CLCA3P	hypertension
GNA14	IgA glomerulonephritis
NUP155	IgA glomerulonephritis
SEC24C	IgA glomerulonephritis
CLCA2	IgA glomerulonephritis
IKBKE	IgA glomerulonephritis
MORF4L2	breast cancer
FNIP1	breast cancer
CTR9	peripheral nervous system disease
GCC2	IgA glomerulonephritis
PLCH2	IgA glomerulonephritis
TTC37	stomach cancer
HS2ST1	Ehlers-Danlos syndrome progeroid type
SOCS5	IgA glomerulonephritis
MDC1	IgA glomerulonephritis
CD59	IgA glomerulonephritis
CEP135	IgA glomerulonephritis
LPIN2	IgA glomerulonephritis
DZIP3	IgA glomerulonephritis
EIF5B	Diamond-Blackfan anemia
CD63	IgA glomerulonephritis
TTI1	breast cancer
TGS1	IgA glomerulonephritis
PPIP5K1	IgA glomerulonephritis
DEPDC5	breast cancer
KDM4A	breast cancer
CLINT1	IgA glomerulonephritis
NUP93	IgA glomerulonephritis
UBE3C	IgA glomerulonephritis
RAPGEF2	IgA glomerulonephritis
EDEM1	IgA glomerulonephritis
PUM1	IgA glomerulonephritis
ACYP1	obesity
CD70	IgA glomerulonephritis
CEP57	IgA glomerulonephritis
ULK2	IgA glomerulonephritis
CD72	IgA glomerulonephritis
FAM131B	IgA glomerulonephritis
AQR	IgA glomerulonephritis
ECE2	IgA glomerulonephritis
UTP14C	dyskeratosis congenita
RAB11FIP3	Bardet-Biedl syndrome
DCAF1	IgA glomerulonephritis
KNTC1	IgA glomerulonephritis
USP34	IgA glomerulonephritis
CCP110	IgA glomerulonephritis
SETD1A	breast cancer
LAPTM4A	IgA glomerulonephritis
ARHGAP32	IgA glomerulonephritis
ACAP1	IgA glomerulonephritis
PHACTR2	IgA glomerulonephritis
TOX	breast cancer
MLEC	IgA glomerulonephritis
ZFYVE16	IgA glomerulonephritis
JADE3	breast cancer
RAPGEF5	breast cancer
EIF4A3	human immunodeficiency virus infectious disease
ATG13	IgA glomerulonephritis
RNF144A	IgA glomerulonephritis
DHX38	human immunodeficiency virus infectious disease
SPCS2	obesity
BMS1	dyskeratosis congenita
PTDSS1	IgA glomerulonephritis
SERTAD2	prostate cancer
CKAP5	IgA glomerulonephritis
MAML1	breast cancer
TATDN2	prostate cancer
IST1	IgA glomerulonephritis
ACYP2	obesity
DAZAP2	prostate cancer
TOMM20	IgA glomerulonephritis
IP6K1	inflammatory bowel disease
RNF40	IgA glomerulonephritis
SFI1	IgA glomerulonephritis
GIT2	IgA glomerulonephritis
NUP58	IgA glomerulonephritis
ARHGEF11	IgA glomerulonephritis
RGP1	IgA glomerulonephritis
ARHGEF17	IgA glomerulonephritis
DNAJC6	IgA glomerulonephritis
LCMT2	stomach cancer
CDK11B	IgA glomerulonephritis
HEPH	IgA glomerulonephritis
C2CD5	IgA glomerulonephritis
PJA2	IgA glomerulonephritis
TOMM70	IgA glomerulonephritis
AREL1	IgA glomerulonephritis
DDX46	human immunodeficiency virus infectious disease
CDC5L	human immunodeficiency virus infectious disease
TBC1D4	IgA glomerulonephritis
POM121	IgA glomerulonephritis
OSBPL2	prostate cancer
RHOBTB1	IgA glomerulonephritis
SMG7	stomach cancer
SEPT7	IgA glomerulonephritis
PLPPR4	IgA glomerulonephritis
NUAK1	breast cancer
SNAP91	IgA glomerulonephritis
TELO2	breast cancer
SV2A	kidney disease
MRC2	IgA glomerulonephritis
KLHL21	IgA glomerulonephritis
RBM19	IgA glomerulonephritis
G3BP2	IgA glomerulonephritis
DENND4B	IgA glomerulonephritis
ARHGAP44	IgA glomerulonephritis
SUPT7L	breast cancer
ARNT2	prostate cancer
FAM20B	IgA glomerulonephritis
NCAPD2	IgA glomerulonephritis
SEC16A	IgA glomerulonephritis
IQSEC1	IgA glomerulonephritis
PAN2	stomach cancer
JOSD1	IgA glomerulonephritis
CDC25A	IgA glomerulonephritis
P2RY14	IgA glomerulonephritis
DCLRE1A	IgA glomerulonephritis
ARHGAP25	IgA glomerulonephritis
XYLB	prostate cancer
GFPT2	IgA glomerulonephritis
CDC25C	IgA glomerulonephritis
HS3ST4	Ehlers-Danlos syndrome progeroid type
HS3ST3A1	Ehlers-Danlos syndrome progeroid type
HS3ST2	Ehlers-Danlos syndrome progeroid type
HS3ST1	Ehlers-Danlos syndrome progeroid type
USP15	IgA glomerulonephritis
CDC27	IgA glomerulonephritis
USP3	IgA glomerulonephritis
MVP	IgA glomerulonephritis
FGF19	breast cancer
THRAP3	breast cancer
MED13	breast cancer
CDC34	IgA glomerulonephritis
NUP153	IgA glomerulonephritis
CLEC2B	IgA glomerulonephritis
FGFBP1	breast cancer
THOC1	human immunodeficiency virus infectious disease
RCE1	IgA glomerulonephritis
HNRNPDL	IgA glomerulonephritis
DMTF1	IgA glomerulonephritis
